city_to,latitude_source,longitude_source,city_from,latitude_target,longitude_target,category,fam_perm19,fam_temp19,ind_perm19,ind_temp19,total_temp19,total_perm19,total19,fam_perm20,fam_temp20,ind_perm20,ind_temp20,total_temp20,total_perm20,total20,width
26420,29.7495926,-95.3536422,20900,29.2784805,-96.2296745,private,8891,289,17113,0,289,26004,26293,9839,302,20815,0,302,30654,30956,22.28966084
38060,33.1857653,-112.0678624,49740,32.7739424,-113.910905,private,8605,345,19487,0,345,28092,28437,8794,345,22503,0,345,31297,31642,22.71728105
49740,32.7739424,-113.910905,38060,33.1857653,-112.0678624,private,6130,398,16934,0,398,23064,23462,5780,339,18762,0,339,24542,24881,18.50279092
20900,29.2784805,-96.2296745,26420,29.7495926,-95.3536422,private,4023,210,10423,0,210,14446,14656,3754,210,11439,0,210,15193,15403,12.5946505
42660,47.4905993,-121.833996,34580,48.4932917,-121.8157703,private,3764,151,10125,0,151,13889,14040,4412,431,12168,0,431,16580,17011,13.59700224
19100,32.8491708,-96.9704894,23620,33.6391964,-97.2103433,private,3360,46,6125,0,46,9485,9531,3916,60,7162,0,60,11078,11138,9.936049642
31080,34.1087033,-118.1827533,40140,34.5384763,-116.1345414,private,8615,232,21499,0,232,30114,30346,9450,513,25341,0,513,34791,35304,25
42660,47.4905993,-121.833996,43220,47.3541257,-123.1738498,private,4524,133,10975,0,133,15499,15632,4953,224,12667,0,224,17620,17844,14.11625535
34580,48.4932917,-121.8157703,42660,47.4905993,-121.833996,private,1919,245,7376,0,245,9295,9540,1608,195,7204,0,195,8812,9007,8.607684243
41860,37.7737185,-122.2744317,41940,36.9084718,-121.3713721,private,2752,144,10004,0,144,12756,12900,2903,228,13194,0,228,16097,16325,13.16938203
43220,47.3541257,-123.1738498,42660,47.4905993,-121.833996,private,2383,191,7940,0,191,10323,10514,2135,145,7954,0,145,10089,10234,9.372538464
31080,34.1087033,-118.1827533,37100,34.3587415,-119.1331432,private,1806,40,4742,0,40,6548,6588,1887,76,5551,0,76,7438,7514,7.677018106
12060,33.693728,-84.3999113,12020,33.943984,-83.2138965,private,1794,58,3253,0,58,5047,5105,1888,85,3555,0,85,5443,5528,6.439038903
35620,40.77493,-73.873758,14860,41.2274128,-73.3670614,private,1026,20,2877,0,20,3903,3923,2308,647,6719,0,647,9027,9674,9.023460743
43220,47.3541257,-123.1738498,10140,47.1137324,-123.8267349,private,1080,36,2085,0,36,3165,3201,1054,36,2218,0,36,3272,3308,5.055195081
35620,40.77493,-73.873758,33100,26.1018281,-80.4787552,private,1560,1641,5635,0,1641,7195,8836,2464,2840,8797,0,2840,11261,14101,11.7830448
16980,41.8235214,-87.8282967,48580,42.6681095,-88.5417306,private,893,52,2292,0,52,3185,3237,1050,201,2591,0,201,3641,3842,5.388065622
42660,47.4905993,-121.833996,10140,47.1137324,-123.8267349,private,1351,54,3443,0,54,4794,4848,1459,138,3841,0,138,5300,5438,6.382937126
35620,40.77493,-73.873758,39100,41.5752737,-74.0338729,private,1250,38,3824,0,38,5074,5112,2192,1353,6958,0,1353,9150,10503,9.54022044
33100,26.1018281,-80.4787552,15980,26.5590348,-81.8919943,private,630,36,2025,0,36,2655,2691,857,57,2630,0,57,3487,3544,5.202306406
26420,29.7495926,-95.3536422,12420,30.2395128,-97.6912697,private,958,29,2816,0,29,3774,3803,958,71,3091,0,71,4049,4120,5.561357776
14460,42.517606,-71.0219925,39300,41.7068313,-71.2866369,private,474,45,2320,145,190,2794,2984,582,192,3054,0,192,3636,3828,5.379338679
33100,26.1018281,-80.4787552,36380,27.3855924,-80.8873884,private,606,43,1246,0,43,1852,1895,726,54,1676,0,54,2402,2456,4.524098263
41860,37.7737185,-122.2744317,31080,34.1087033,-118.1827533,private,641,0,4666,0,0,5307,5307,820,119,7438,0,119,8258,8377,8.214971807
35620,40.77493,-73.873758,31080,34.1087033,-118.1827533,private,556,27,6133,0,27,6689,6716,737,257,8018,0,257,8755,9012,8.610801009
31080,34.1087033,-118.1827533,29820,36.2142575,-115.013812,private,1049,0,3854,0,0,4903,4903,1212,68,4707,0,68,5919,5987,6.725157963
41860,37.7737185,-122.2744317,46380,39.4323876,-123.4428811,private,193,20,611,0,20,804,824,376,222,1460,0,222,1836,2058,4.27600374
35620,40.77493,-73.873758,28740,41.9472124,-74.2654582,private,102,52,599,0,52,701,753,462,1085,1885,0,1085,2347,3432,5.132490862
33100,26.1018281,-80.4787552,36740,28.4343962,-81.3560839,private,1428,74,4054,0,74,5482,5556,1466,104,4780,0,104,6246,6350,6.951435129
49740,32.7739424,-113.910905,39150,34.631071,-112.5772247,private,377,256,612,0,256,989,1245,455,260,731,0,260,1186,1446,3.89451166
12060,33.693728,-84.3999113,16860,35.0493612,-85.3611582,private,820,0,1868,0,0,2688,2688,763,13,2057,0,13,2820,2833,4.759102372
14460,42.517606,-71.0219925,12700,41.7990145,-70.2118803,private,240,206,665,305,511,905,1416,451,663,1245,0,663,1696,2359,4.463633015
31080,34.1087033,-118.1827533,41740,33.0236041,-116.7761174,private,1261,0,5335,0,0,6596,6596,1446,68,6895,0,68,8341,8409,8.234919106
34580,48.4932917,-121.8157703,43220,47.3541257,-123.1738498,private,320,20,865,0,20,1185,1205,310,26,980,0,26,1290,1316,3.81347576
14460,42.517606,-71.0219925,35620,40.77493,-73.873758,private,233,14,3556,195,209,3789,3998,219,12,3126,0,12,3345,3357,5.085739382
26420,29.7495926,-95.3536422,19100,32.8491708,-96.9704894,private,1071,39,3427,0,39,4498,4537,956,29,3623,0,29,4579,4608,5.865554076
41860,37.7737185,-122.2744317,41740,33.0236041,-116.7761174,private,301,0,1459,0,0,1760,1760,446,86,2773,0,86,3219,3305,5.053325022
38060,33.1857653,-112.0678624,46060,32.1280427,-111.7836574,private,824,42,2523,0,42,3347,3389,905,84,3060,0,84,3965,4049,5.517099708
16980,41.8235214,-87.8282967,34940,26.118786,-81.4009553,private,465,1507,516,0,1507,981,2488,579,2109,599,0,2109,1178,3287,5.042104667
38060,33.1857653,-112.0678624,39150,34.631071,-112.5772247,private,562,243,1266,0,243,1828,2071,731,307,1572,0,307,2303,2610,4.620094636
41860,37.7737185,-122.2744317,35620,40.77493,-73.873758,private,251,17,2759,0,17,3010,3027,169,28,2757,0,28,2926,2954,4.834528093
19100,32.8491708,-96.9704894,46340,32.3770156,-95.2700409,private,656,0,1460,0,0,2116,2116,842,36,1701,0,36,2543,2579,4.600770691
33460,45.096664,-93.275361,31860,44.1548096,-94.1478013,private,407,0,1541,0,0,1948,1948,479,24,1691,0,24,2170,2194,4.360779758
35620,40.77493,-73.873758,37980,39.8949576,-75.3119824,private,728,11,4056,0,11,4784,4795,1233,495,6845,0,495,8078,8573,8.33714901
41860,37.7737185,-122.2744317,40900,38.7896779,-121.0057504,private,706,0,2252,0,0,2958,2958,1018,89,3647,0,89,4665,4754,5.956563625
35620,40.77493,-73.873758,14460,42.517606,-71.0219925,private,274,0,2907,0,0,3181,3181,477,286,4382,0,286,4859,5145,6.200294676
41860,37.7737185,-122.2744317,42660,47.4905993,-121.833996,private,326,0,1933,0,0,2259,2259,419,43,2470,0,43,2889,2932,4.820814326
19100,32.8491708,-96.9704894,12420,30.2395128,-97.6912697,private,1009,13,2983,0,13,3992,4005,933,52,3004,0,52,3937,3989,5.479698524
12060,33.693728,-84.3999113,31420,32.8562163,-83.714305,private,1002,27,2129,0,27,3131,3158,1105,101,2609,0,101,3714,3815,5.371235089
16980,41.8235214,-87.8282967,40300,42.041884,-89.3201764,private,523,0,1354,0,0,1877,1877,584,26,1635,0,26,2219,2245,4.392570765
35620,40.77493,-73.873758,45860,41.7918833,-73.2354042,private,127,15,503,0,15,630,645,368,756,1029,0,756,1397,2153,4.335222282
43220,47.3541257,-123.1738498,34580,48.4932917,-121.8157703,private,307,24,745,0,24,1052,1076,314,21,751,0,21,1065,1086,3.670104553
26420,29.7495926,-95.3536422,41700,29.4330599,-98.6069734,private,557,17,1438,0,17,1995,2012,507,31,1534,0,31,2041,2072,4.284730683
41860,37.7737185,-122.2744317,33700,37.5623162,-121.0028311,private,290,11,691,0,11,981,992,364,41,1080,0,41,1444,1485,3.918822429
16980,41.8235214,-87.8282967,38060,33.1857653,-112.0678624,private,1169,1046,2476,0,1046,3645,4691,1149,1262,2576,0,1262,3725,4987,6.10180489
42660,47.4905993,-121.833996,38060,33.1857653,-112.0678624,private,540,522,1328,0,522,1868,2390,629,706,1557,0,706,2186,2892,4.795880203
33460,45.096664,-93.275361,14660,46.7672909,-94.2238624,private,415,225,850,0,225,1265,1490,633,517,1040,0,517,1673,2190,4.358286346
42660,47.4905993,-121.833996,49740,32.7739424,-113.910905,private,352,542,613,0,542,965,1507,374,591,688,0,591,1062,1653,4.023545746
19100,32.8491708,-96.9704894,26420,29.7495926,-95.3536422,private,552,31,2205,0,31,2757,2788,555,34,2377,0,34,2932,2966,4.84200833
33460,45.096664,-93.275361,38060,33.1857653,-112.0678624,private,493,1846,1049,0,1846,1542,3388,474,1874,1015,0,1874,1489,3363,5.0894795
38060,33.1857653,-112.0678624,22380,35.8296919,-111.7737277,private,313,494,798,0,494,1111,1605,344,578,976,0,578,1320,1898,4.176267248
33100,26.1018281,-80.4787552,29460,27.9536488,-81.6935337,private,379,0,917,0,0,1296,1296,449,51,1167,0,51,1616,1667,4.032272689
34580,48.4932917,-121.8157703,49740,32.7739424,-113.910905,private,175,509,247,0,509,422,931,216,509,257,0,509,473,982,3.605275834
35620,40.77493,-73.873758,41860,37.7737185,-122.2744317,private,336,11,3315,0,11,3651,3662,319,90,3382,0,90,3701,3791,5.356274615
42660,47.4905993,-121.833996,38900,45.6006221,-122.484378,private,705,28,2643,0,28,3348,3376,689,94,3030,0,94,3719,3813,5.369988383
16980,41.8235214,-87.8282967,19740,39.434789,-104.9010728,private,462,0,2050,0,0,2512,2512,413,11,2050,0,11,2463,2474,4.535318618
14460,42.517606,-71.0219925,31700,42.9115317,-71.7230554,private,174,0,818,44,44,992,1036,234,16,1004,0,16,1238,1254,3.77482787
35620,40.77493,-73.873758,16980,41.8235214,-87.8282967,private,168,0,2020,0,0,2188,2188,246,61,2965,0,61,3211,3272,5.032754371
14460,42.517606,-71.0219925,49340,42.2173112,-71.9255354,private,288,0,1439,36,36,1727,1763,344,11,1831,0,11,2175,2186,4.355792933
49740,32.7739424,-113.910905,34580,48.4932917,-121.8157703,private,214,491,227,0,491,441,932,200,372,206,0,372,406,778,3.478111807
42660,47.4905993,-121.833996,49420,46.4565581,-120.7401446,private,333,0,877,0,0,1210,1210,390,53,1124,0,53,1514,1567,3.969937381
41860,37.7737185,-122.2744317,12420,30.2395128,-97.6912697,private,275,0,948,0,0,1223,1223,408,16,1370,0,16,1778,1794,4.111438529
47900,38.7982054,-77.4868816,35620,40.77493,-73.873758,private,115,11,2117,0,11,2232,2243,104,17,1929,0,17,2033,2050,4.271016916
43220,47.3541257,-123.1738498,49740,32.7739424,-113.910905,private,168,463,258,0,463,426,889,178,475,254,0,475,432,907,3.558524353
16980,41.8235214,-87.8282967,35620,40.77493,-73.873758,private,208,0,2686,0,0,2894,2894,165,0,2093,0,0,2258,2258,4.400674355
31080,34.1087033,-118.1827533,41860,37.7737185,-122.2744317,private,814,0,5786,0,0,6600,6600,672,80,6093,0,80,6765,6845,7.2599949
35620,40.77493,-73.873758,47900,38.7982054,-77.4868816,private,367,16,3744,0,16,4111,4127,572,327,5563,0,327,6135,6462,7.021250673
33100,26.1018281,-80.4787552,45300,28.1259071,-82.4652858,private,847,46,2964,0,46,3811,3857,859,53,3170,0,53,4029,4082,5.53767036
41860,37.7737185,-122.2744317,45000,40.7210862,-120.6299518,private,61,20,228,0,20,289,309,182,203,775,0,203,957,1160,3.716232681
35620,40.77493,-73.873758,35300,41.3497185,-72.9002033,private,203,14,1067,0,14,1270,1284,460,317,2173,0,317,2633,2950,4.832034681
34580,48.4932917,-121.8157703,10140,47.1137324,-123.8267349,private,207,11,596,0,11,803,814,234,21,608,0,21,842,863,3.531096818
41860,37.7737185,-122.2744317,38900,45.6006221,-122.484378,private,236,0,960,0,0,1196,1196,302,23,1391,0,23,1693,1716,4.062816989
38060,33.1857653,-112.0678624,42660,47.4905993,-121.833996,private,416,555,1283,0,555,1699,2254,366,440,1083,0,440,1449,1889,4.170657071
49740,32.7739424,-113.910905,43220,47.3541257,-123.1738498,private,195,427,229,0,427,424,851,180,352,230,0,352,410,762,3.468138158
47900,38.7982054,-77.4868816,12580,39.304361,-76.5495009,private,208,0,1083,0,0,1291,1291,241,26,1585,0,26,1826,1852,4.147593007
37980,39.8949576,-75.3119824,12100,39.4693555,-74.6337591,private,295,499,511,0,499,806,1305,449,854,790,0,854,1239,2093,4.297821098
16980,41.8235214,-87.8282967,42660,47.4905993,-121.833996,private,300,0,1769,0,0,2069,2069,205,0,1418,0,0,1623,1623,4.004845153
16980,41.8235214,-87.8282967,33100,26.1018281,-80.4787552,private,575,926,1700,0,926,2275,3201,638,1233,1832,0,1233,2470,3703,5.301419545
16980,41.8235214,-87.8282967,35840,27.3642461,-82.3193579,private,447,944,691,0,944,1138,2082,618,1100,736,0,1100,1354,2454,4.522851557
33460,45.096664,-93.275361,15980,26.5590348,-81.8919943,private,228,978,315,0,978,543,1521,286,1017,343,0,1017,629,1646,4.019182274
35620,40.77493,-73.873758,12060,33.693728,-84.3999113,private,536,0,2865,0,0,3401,3401,792,129,4229,0,129,5021,5150,6.203411441
20900,29.2784805,-96.2296745,12420,30.2395128,-97.6912697,private,437,26,753,0,26,1190,1216,500,28,895,0,28,1395,1423,3.880174539
16980,41.8235214,-87.8282967,31080,34.1087033,-118.1827533,private,461,27,2902,0,27,3363,3390,385,79,2659,0,79,3044,3123,4.939874763
38060,33.1857653,-112.0678624,33460,45.096664,-93.275361,private,812,1628,1098,0,1628,1910,3538,908,1407,1170,0,1407,2078,3485,5.165528575
35620,40.77493,-73.873758,38340,42.371493,-73.2179276,private,27,60,90,0,60,117,177,132,636,419,0,636,551,1187,3.733063214
33100,26.1018281,-80.4787552,37340,28.2983112,-80.7003334,private,340,16,725,0,16,1065,1081,384,22,934,0,22,1318,1340,3.828436234
35620,40.77493,-73.873758,12420,30.2395128,-97.6912697,private,120,0,1175,0,0,1295,1295,269,52,1755,0,52,2024,2076,4.287224095
16980,41.8235214,-87.8282967,15980,26.5590348,-81.8919943,private,521,1239,723,0,1239,1244,2483,590,1363,807,0,1363,1397,2760,4.713597597
31080,34.1087033,-118.1827533,35620,40.77493,-73.873758,private,202,26,3442,0,26,3644,3670,97,26,3323,0,26,3420,3446,5.141217805
49740,32.7739424,-113.910905,42660,47.4905993,-121.833996,private,255,641,423,0,641,678,1319,254,506,399,0,506,653,1159,3.715609328
33100,26.1018281,-80.4787552,12060,33.693728,-84.3999113,private,674,89,2069,0,89,2743,2832,705,105,2349,0,105,3054,3159,4.962315473
31080,34.1087033,-118.1827533,42660,47.4905993,-121.833996,private,455,0,2953,0,0,3408,3408,455,12,3100,0,12,3555,3567,5.216643527
26420,29.7495926,-95.3536422,17780,30.7543917,-96.4885368,private,317,0,700,0,0,1017,1017,302,13,796,0,13,1098,1111,3.68568838
16980,41.8235214,-87.8282967,12420,30.2395128,-97.6912697,private,423,22,1132,0,22,1555,1577,368,41,1255,0,41,1623,1664,4.030402629
38060,33.1857653,-112.0678624,40940,32.9318277,-109.8783103,private,344,149,631,0,149,975,1124,389,225,769,0,225,1158,1383,3.855240416
14460,42.517606,-71.0219925,16980,41.8235214,-87.8282967,private,77,0,991,22,22,1068,1090,80,0,915,0,0,995,995,3.613379424
49740,32.7739424,-113.910905,46060,32.1280427,-111.7836574,private,342,45,744,0,45,1086,1131,324,40,803,0,40,1127,1167,3.720596152
35620,40.77493,-73.873758,25540,41.7186503,-72.5739191,private,133,0,651,0,0,784,784,288,443,1374,0,443,1662,2105,4.305301335
19100,32.8491708,-96.9704894,41700,29.4330599,-98.6069734,private,420,15,1263,0,15,1683,1698,438,11,1271,0,11,1709,1720,4.065310401
37980,39.8949576,-75.3119824,35620,40.77493,-73.873758,private,361,0,3410,0,0,3771,3771,304,11,3385,0,11,3689,3700,5.299549486
41860,37.7737185,-122.2744317,19740,39.434789,-104.9010728,private,183,0,827,0,0,1010,1010,215,15,1197,0,15,1412,1427,3.882667951
33100,26.1018281,-80.4787552,34940,26.118786,-81.4009553,private,313,22,755,0,22,1068,1090,366,25,964,0,25,1330,1355,3.83778653
38060,33.1857653,-112.0678624,16980,41.8235214,-87.8282967,private,620,1118,1361,0,1118,1981,3099,557,904,1469,0,904,2026,2930,4.81956762
35620,40.77493,-73.873758,45940,40.2825026,-74.703724,private,175,0,722,0,0,897,897,342,122,1340,0,122,1682,1804,4.11767206
33100,26.1018281,-80.4787552,27260,30.2365943,-81.7544462,private,533,36,1298,0,36,1831,1867,542,47,1566,0,47,2108,2155,4.336468988
16980,41.8235214,-87.8282967,33340,43.0176601,-87.4815541,private,411,0,1533,0,0,1944,1944,449,35,1645,0,35,2094,2129,4.320261808
20900,29.2784805,-96.2296745,19100,32.8491708,-96.9704894,private,456,14,893,0,14,1349,1363,398,15,875,0,15,1273,1288,3.796021874
42660,47.4905993,-121.833996,40140,34.5384763,-116.1345414,private,217,653,578,0,653,795,1448,260,799,668,0,799,928,1727,4.069673873
31080,34.1087033,-118.1827533,38900,45.6006221,-122.484378,private,367,0,1845,0,0,2212,2212,312,13,2229,0,13,2541,2554,4.585186864
49740,32.7739424,-113.910905,22380,35.8296919,-111.7737277,private,116,268,263,0,268,379,647,125,269,267,0,269,392,661,3.405179497
43220,47.3541257,-123.1738498,41740,33.0236041,-116.7761174,private,170,56,271,0,56,441,497,365,118,663,0,118,1028,1146,3.707505738
31080,34.1087033,-118.1827533,12420,30.2395128,-97.6912697,private,396,0,1467,0,0,1863,1863,523,0,2011,0,0,2534,2534,4.572719803
38060,33.1857653,-112.0678624,25720,40.6913977,-111.0527658,private,312,186,425,0,186,737,923,346,173,494,0,173,840,1013,3.624599779
33460,45.096664,-93.275361,34940,26.118786,-81.4009553,private,192,811,209,0,811,401,1212,209,926,224,0,926,433,1359,3.840279942
35620,40.77493,-73.873758,39300,41.7068313,-71.2866369,private,75,23,649,0,23,724,747,170,377,1353,0,377,1523,1900,4.177513955
20900,29.2784805,-96.2296745,17780,30.7543917,-96.4885368,private,227,0,413,0,0,640,640,212,0,394,0,0,606,606,3.370895078
42660,47.4905993,-121.833996,44060,48.091618,-117.663472,private,544,11,1532,0,11,2076,2087,585,65,1801,0,65,2386,2451,4.520981498
19100,32.8491708,-96.9704894,20900,29.2784805,-96.2296745,private,304,15,677,0,15,981,996,274,11,670,0,11,944,955,3.588445301
49740,32.7739424,-113.910905,10140,47.1137324,-123.8267349,private,173,347,116,0,347,289,636,165,296,137,0,296,302,598,3.365908254
33460,45.096664,-93.275361,49740,32.7739424,-113.910905,private,246,710,354,0,710,600,1310,186,761,282,0,761,468,1229,3.759244043
14460,42.517606,-71.0219925,38860,43.6514172,-70.4183755,private,90,28,564,74,102,654,756,185,194,902,0,194,1087,1281,3.791658403
35620,40.77493,-73.873758,26420,29.7495926,-95.3536422,private,178,14,985,0,14,1163,1177,211,36,1334,0,36,1545,1581,3.978664324
16980,41.8235214,-87.8282967,40420,42.331183,-89.0429139,private,329,0,1280,0,0,1609,1609,317,0,1414,0,0,1731,1731,4.072167285
49740,32.7739424,-113.910905,38900,45.6006221,-122.484378,private,352,648,412,0,648,764,1412,299,549,406,0,549,705,1254,3.77482787
14460,42.517606,-71.0219925,44140,42.3648332,-72.6194063,private,67,0,580,33,33,647,680,98,34,781,0,34,879,913,3.562264472
47900,38.7982054,-77.4868816,15680,38.2202894,-76.5303837,private,102,0,352,0,0,454,454,147,24,444,0,24,591,615,3.376505256
35620,40.77493,-73.873758,19740,39.434789,-104.9010728,private,114,0,1086,0,0,1200,1200,204,53,1675,0,53,1879,1932,4.197461253
14460,42.517606,-71.0219925,33100,26.1018281,-80.4787552,private,164,216,794,320,536,958,1494,171,277,971,0,277,1142,1419,3.877681127
14460,42.517606,-71.0219925,41860,37.7737185,-122.2744317,private,117,0,1387,77,77,1504,1581,83,11,1186,0,11,1269,1280,3.791035049
41860,37.7737185,-122.2744317,40140,34.5384763,-116.1345414,private,88,41,501,0,41,589,630,160,126,948,0,126,1108,1234,3.762360808
16980,41.8235214,-87.8282967,16580,40.1029885,-88.3185039,private,200,0,805,0,0,1005,1005,208,11,954,0,11,1162,1173,3.724336271
14460,42.517606,-71.0219925,47900,38.7982054,-77.4868816,private,147,0,1327,61,61,1474,1535,114,11,1382,0,11,1496,1507,3.932536197
33100,26.1018281,-80.4787552,36100,29.2028047,-82.0431004,private,246,21,541,0,21,787,808,299,19,643,0,19,942,961,3.592185419
33100,26.1018281,-80.4787552,35620,40.77493,-73.873758,private,902,1716,3142,0,1716,4044,5760,786,1329,2896,0,1329,3682,5011,6.116765364
35620,40.77493,-73.873758,42660,47.4905993,-121.833996,private,132,0,1624,0,0,1756,1756,158,29,1817,0,29,1975,2004,4.242342674
16980,41.8235214,-87.8282967,11460,42.2522168,-83.8434233,private,136,0,642,0,0,778,778,154,15,728,0,15,882,897,3.552290823
37980,39.8949576,-75.3119824,33100,26.1018281,-80.4787552,private,294,494,786,0,494,1080,1574,329,536,871,0,536,1200,1736,4.075284051
33100,26.1018281,-80.4787552,35840,27.3642461,-82.3193579,private,224,34,599,0,34,823,857,293,21,776,0,21,1069,1090,3.672597966
33460,45.096664,-93.275361,40340,43.9496362,-92.3360701,private,238,25,1027,0,25,1265,1290,261,38,1092,0,38,1353,1391,3.860227241
31080,34.1087033,-118.1827533,38060,33.1857653,-112.0678624,private,760,0,2808,0,0,3568,3568,930,57,3336,0,57,4266,4323,5.68789845
26420,29.7495926,-95.3536422,32580,26.3963839,-98.18099,private,209,0,535,0,0,744,744,234,27,680,0,27,914,941,3.579718358
34580,48.4932917,-121.8157703,38060,33.1857653,-112.0678624,private,219,408,405,0,408,624,1032,239,389,405,0,389,644,1033,3.63706684
16980,41.8235214,-87.8282967,12060,33.693728,-84.3999113,private,714,12,2110,0,12,2824,2836,639,31,2155,0,31,2794,2825,4.754115547
31080,34.1087033,-118.1827533,16980,41.8235214,-87.8282967,private,149,0,1707,0,0,1856,1856,144,12,2169,0,12,2313,2325,4.442439011
16980,41.8235214,-87.8282967,14460,42.517606,-71.0219925,private,170,0,1012,0,0,1182,1182,71,0,964,0,0,1035,1035,3.638313547
42660,47.4905993,-121.833996,19100,32.8491708,-96.9704894,private,338,12,951,0,12,1289,1301,395,17,1070,0,17,1465,1482,3.91695237
38060,33.1857653,-112.0678624,19740,39.434789,-104.9010728,private,467,539,1230,0,539,1697,2236,452,499,1280,0,499,1732,2231,4.383843822
33100,26.1018281,-80.4787552,37260,29.5938964,-81.7320389,private,228,16,496,0,16,724,740,231,28,605,0,28,836,864,3.531720171
16980,41.8235214,-87.8282967,26420,29.7495926,-95.3536422,private,254,11,901,0,11,1155,1166,205,0,970,0,0,1175,1175,3.725582977
49740,32.7739424,-113.910905,33460,45.096664,-93.275361,private,355,887,367,0,887,722,1609,362,813,384,0,813,746,1559,3.964950557
31080,34.1087033,-118.1827533,33100,26.1018281,-80.4787552,private,231,0,1438,0,0,1669,1669,312,18,1890,0,18,2202,2220,4.376986938
38060,33.1857653,-112.0678624,31080,34.1087033,-118.1827533,private,410,198,2242,0,198,2652,2850,342,172,2199,0,172,2541,2713,4.684300003
42660,47.4905993,-121.833996,28420,46.3639636,-119.2540459,private,259,0,663,0,0,922,922,264,44,726,0,44,990,1034,3.637690194
33460,45.096664,-93.275361,16980,41.8235214,-87.8282967,private,249,0,1457,0,0,1706,1706,141,0,1172,0,0,1313,1313,3.811605701
42660,47.4905993,-121.833996,17660,47.6759658,-116.6959222,private,181,23,283,0,23,464,487,275,73,474,0,73,749,822,3.505539342
16980,41.8235214,-87.8282967,41860,37.7737185,-122.2744317,private,338,0,1851,0,0,2189,2189,195,25,1399,0,25,1594,1619,4.002351741
38060,33.1857653,-112.0678624,41740,33.0236041,-116.7761174,private,318,324,1166,0,324,1484,1808,299,243,1235,0,243,1534,1777,4.100841527
14460,42.517606,-71.0219925,42660,47.4905993,-121.833996,private,68,0,738,47,47,806,853,71,0,775,0,0,846,846,3.520499816
16980,41.8235214,-87.8282967,26900,39.74867,-86.2123823,private,454,0,1235,0,0,1689,1689,503,0,1445,0,0,1948,1948,4.207434902
12060,33.693728,-84.3999113,24860,34.6837085,-82.4134227,private,331,0,636,0,0,967,967,345,50,703,0,50,1048,1098,3.67758479
16980,41.8235214,-87.8282967,33460,45.096664,-93.275361,private,349,0,1374,0,0,1723,1723,261,27,1439,0,27,1700,1727,4.069673873
42660,47.4905993,-121.833996,41860,37.7737185,-122.2744317,private,434,25,2146,0,25,2580,2605,282,89,1783,0,89,2065,2154,4.335845635
31080,34.1087033,-118.1827533,26420,29.7495926,-95.3536422,private,196,0,949,0,0,1145,1145,188,11,1310,0,11,1498,1509,3.933782903
31080,34.1087033,-118.1827533,12540,35.3466288,-118.7295064,private,757,0,2214,0,0,2971,2971,824,0,2548,0,0,3372,3372,5.095089678
42660,47.4905993,-121.833996,41740,33.0236041,-116.7761174,private,245,47,988,0,47,1233,1280,234,121,1109,0,121,1343,1464,3.905732015
26420,29.7495926,-95.3536422,13140,30.0759278,-94.2027049,private,359,0,871,0,0,1230,1230,332,0,980,0,0,1312,1312,3.810982348
42660,47.4905993,-121.833996,31080,34.1087033,-118.1827533,private,438,21,2618,0,21,3056,3077,433,137,2738,0,137,3171,3308,5.055195081
19100,32.8491708,-96.9704894,42660,47.4905993,-121.833996,private,244,12,1021,0,12,1265,1277,118,16,692,0,16,810,826,3.508032754
33100,26.1018281,-80.4787552,26420,29.7495926,-95.3536422,private,132,19,794,0,19,926,945,128,11,720,0,11,848,859,3.528603406
35620,40.77493,-73.873758,16740,35.1663423,-80.7972848,private,209,0,1189,0,0,1398,1398,360,63,1875,0,63,2235,2298,4.425608478
47900,38.7982054,-77.4868816,16980,41.8235214,-87.8282967,private,38,0,623,0,0,661,661,55,13,691,0,13,746,759,3.466268098
16980,41.8235214,-87.8282967,41180,38.7402108,-90.3458253,private,308,0,1144,0,0,1452,1452,300,12,1395,0,12,1695,1707,4.057206812
34580,48.4932917,-121.8157703,38900,45.6006221,-122.484378,private,226,24,703,0,24,929,953,171,22,758,0,22,929,951,3.585951888
31080,34.1087033,-118.1827533,12060,33.693728,-84.3999113,private,307,0,1668,0,0,1975,1975,256,34,2404,0,34,2660,2694,4.672456294
47900,38.7982054,-77.4868816,14460,42.517606,-71.0219925,private,52,0,738,0,0,790,790,51,0,741,0,0,792,792,3.48683875
16980,41.8235214,-87.8282967,19100,32.8491708,-96.9704894,private,981,24,2395,0,24,3376,3400,880,53,2437,0,53,3317,3370,5.093842972
16980,41.8235214,-87.8282967,49740,32.7739424,-113.910905,private,478,441,857,0,441,1335,1776,470,505,807,0,505,1277,1782,4.103958292
38060,33.1857653,-112.0678624,34580,48.4932917,-121.8157703,private,184,379,328,0,379,512,891,206,339,310,0,339,516,855,3.526109993
33460,45.096664,-93.275361,20260,47.3475056,-92.1553326,private,335,111,1190,0,111,1525,1636,449,249,1390,0,249,1839,2088,4.294704332
41860,37.7737185,-122.2744317,16980,41.8235214,-87.8282967,private,95,0,841,0,0,936,936,105,0,1096,0,0,1201,1201,3.741790157
35620,40.77493,-73.873758,19100,32.8491708,-96.9704894,private,225,0,1326,0,0,1551,1551,355,40,1947,0,40,2302,2342,4.453036013
35620,40.77493,-73.873758,35840,27.3642461,-82.3193579,private,117,85,337,0,85,454,539,169,252,639,0,252,808,1060,3.653897373
16980,41.8235214,-87.8282967,28020,42.2462657,-85.5328544,private,189,12,453,0,12,642,654,266,183,611,0,183,877,1060,3.653897373
12060,33.693728,-84.3999113,19100,32.8491708,-96.9704894,private,574,12,1680,0,12,2254,2266,399,15,1591,0,15,1990,2005,4.242966027
14460,42.517606,-71.0219925,31080,34.1087033,-118.1827533,private,90,0,1287,62,62,1377,1439,77,16,1218,0,16,1295,1311,3.810358995
43220,47.3541257,-123.1738498,38900,45.6006221,-122.484378,private,224,0,544,0,0,768,768,229,0,587,0,0,816,816,3.501799224
19100,32.8491708,-96.9704894,47380,31.4272264,-97.0934727,private,413,0,765,0,0,1178,1178,358,0,837,0,0,1195,1195,3.738050038
35620,40.77493,-73.873758,12700,41.7990145,-70.2118803,private,28,137,160,0,137,188,325,152,626,591,0,626,743,1369,3.846513473
49740,32.7739424,-113.910905,14260,43.0066485,-116.1419089,private,160,222,175,0,222,335,557,194,220,207,0,220,401,621,3.380245374
35620,40.77493,-73.873758,10580,42.7879202,-73.9423479,private,111,0,845,0,0,956,956,321,287,1547,0,287,1868,2155,4.336468988
37980,39.8949576,-75.3119824,41540,38.3995211,-75.4782615,private,214,27,541,0,27,755,782,226,90,664,0,90,890,980,3.604029128
34580,48.4932917,-121.8157703,40140,34.5384763,-116.1345414,private,94,346,190,0,346,284,630,90,350,182,0,350,272,622,3.380868728
16980,41.8235214,-87.8282967,36837,41.3564879,-89.1733848,private,278,0,859,0,0,1137,1137,296,0,907,0,0,1203,1203,3.743036863
12060,33.693728,-84.3999113,16740,35.1663423,-80.7972848,private,518,0,1430,0,0,1948,1948,443,0,1445,0,0,1888,1888,4.170033718
12060,33.693728,-84.3999113,27260,30.2365943,-81.7544462,private,561,38,1255,0,38,1816,1854,627,63,1352,0,63,1979,2042,4.266030091
14460,42.517606,-71.0219925,37980,39.8949576,-75.3119824,private,64,0,775,29,29,839,868,84,0,909,0,0,993,993,3.612132718
16980,41.8235214,-87.8282967,29820,36.2142575,-115.013812,private,280,74,803,0,74,1083,1157,258,81,813,0,81,1071,1152,3.711245856
31080,34.1087033,-118.1827533,41940,36.9084718,-121.3713721,private,230,0,1819,0,0,2049,2049,184,13,1869,0,13,2053,2066,4.280990565
49740,32.7739424,-113.910905,10540,44.4888982,-122.5372084,private,116,233,106,0,233,222,455,121,187,124,0,187,245,432,3.262431644
49740,32.7739424,-113.910905,17660,47.6759658,-116.6959222,private,124,241,74,0,241,198,439,111,239,104,0,239,215,454,3.276145411
12060,33.693728,-84.3999113,33100,26.1018281,-80.4787552,private,803,100,2444,0,100,3247,3347,599,134,2435,0,134,3034,3168,4.967925651
43220,47.3541257,-123.1738498,38060,33.1857653,-112.0678624,private,184,314,282,0,314,466,780,196,300,376,0,300,572,872,3.536706996
14460,42.517606,-71.0219925,34940,26.118786,-81.4009553,private,45,155,93,158,313,138,451,46,191,119,0,191,165,356,3.21505681
14460,42.517606,-71.0219925,29060,43.5191091,-71.4253661,private,36,19,137,20,39,173,212,75,144,232,0,144,307,451,3.274275352
35620,40.77493,-73.873758,20700,41.0562401,-75.3290651,private,215,0,597,0,0,812,812,337,276,907,0,276,1244,1520,3.940639787
49740,32.7739424,-113.910905,40700,43.2863277,-123.154476,private,125,207,106,0,207,231,438,126,168,150,0,168,276,444,3.269911881
34580,48.4932917,-121.8157703,44060,48.091618,-117.663472,private,293,0,630,0,0,923,923,317,23,700,0,23,1017,1040,3.641430312
20900,29.2784805,-96.2296745,41700,29.4330599,-98.6069734,private,262,0,423,0,0,685,685,239,12,436,0,12,675,687,3.421386677
49740,32.7739424,-113.910905,25720,40.6913977,-111.0527658,private,149,137,153,0,137,302,439,141,108,167,0,108,308,416,3.252457995
38060,33.1857653,-112.0678624,29820,36.2142575,-115.013812,private,191,13,714,0,13,905,918,197,0,710,0,0,907,907,3.558524353
38060,33.1857653,-112.0678624,19100,32.8491708,-96.9704894,private,414,16,1128,0,16,1542,1558,384,0,1161,0,0,1545,1545,3.956223614
31080,34.1087033,-118.1827533,19100,32.8491708,-96.9704894,private,705,0,2300,0,0,3005,3005,896,30,2978,0,30,3874,3904,5.426713513
35620,40.77493,-73.873758,34940,26.118786,-81.4009553,private,63,129,194,0,129,257,386,148,275,417,0,275,565,840,3.516759697
12060,33.693728,-84.3999113,35840,27.3642461,-82.3193579,private,208,97,414,0,97,622,719,282,141,494,0,141,776,917,3.564757884
31080,34.1087033,-118.1827533,42200,34.5370572,-120.0399729,private,89,0,547,0,0,636,636,152,14,801,0,14,953,967,3.595925538
42660,47.4905993,-121.833996,14260,43.0066485,-116.1419089,private,259,0,504,0,0,763,763,373,14,694,0,14,1067,1081,3.666987788
37980,39.8949576,-75.3119824,10900,40.7893392,-75.398158,private,228,0,756,0,0,984,984,220,14,894,0,14,1114,1128,3.696285382
49740,32.7739424,-113.910905,29420,35.717705,-113.7496891,private,118,19,278,0,19,396,415,133,15,277,0,15,410,425,3.258068172
16980,41.8235214,-87.8282967,47900,38.7982054,-77.4868816,private,255,0,1501,0,0,1756,1756,182,13,1491,0,13,1673,1686,4.044116397
19100,32.8491708,-96.9704894,12060,33.693728,-84.3999113,private,368,0,1096,0,0,1464,1464,278,13,1128,0,13,1406,1419,3.877681127
31080,34.1087033,-118.1827533,42020,35.3852242,-120.4475445,private,228,0,855,0,0,1083,1083,303,43,1231,0,43,1534,1577,3.976170912
42660,47.4905993,-121.833996,35620,40.77493,-73.873758,private,93,12,1361,0,12,1454,1466,49,0,995,0,0,1044,1044,3.643923724
42660,47.4905993,-121.833996,12420,30.2395128,-97.6912697,private,293,0,807,0,0,1100,1100,322,11,846,0,11,1168,1179,3.728076389
35620,40.77493,-73.873758,41740,33.0236041,-116.7761174,private,83,0,898,0,0,981,981,147,71,1350,0,71,1497,1568,3.970560734
26420,29.7495926,-95.3536422,19740,39.434789,-104.9010728,private,199,0,692,0,0,891,891,173,0,676,0,0,849,849,3.522369875
35620,40.77493,-73.873758,15380,43.0443711,-78.7773351,private,186,0,691,0,0,877,877,464,56,1445,0,56,1909,1965,4.218031904
12060,33.693728,-84.3999113,16980,41.8235214,-87.8282967,private,288,0,1516,0,0,1804,1804,207,0,1404,0,0,1611,1611,3.997364917
35620,40.77493,-73.873758,16700,33.0180695,-80.0075006,private,70,0,303,0,0,373,373,128,107,604,0,107,732,839,3.516136344
12060,33.693728,-84.3999113,17980,32.4193768,-84.8437095,private,383,0,940,0,0,1323,1323,395,0,1071,0,0,1466,1466,3.906978721
19100,32.8491708,-96.9704894,28660,31.2027301,-97.7896384,private,209,0,488,0,0,697,697,179,16,597,0,16,776,792,3.48683875
16980,41.8235214,-87.8282967,41740,33.0236041,-116.7761174,private,241,37,1064,0,37,1305,1342,259,85,1012,0,85,1271,1356,3.838409883
31080,34.1087033,-118.1827533,49740,32.7739424,-113.910905,private,437,0,1216,0,0,1653,1653,528,28,1517,0,28,2045,2073,4.285354036
42660,47.4905993,-121.833996,29820,36.2142575,-115.013812,private,188,21,526,0,21,714,735,148,44,588,0,44,736,780,3.479358513
16980,41.8235214,-87.8282967,19820,42.7218478,-83.2008463,private,269,0,1001,0,0,1270,1270,249,22,1208,0,22,1457,1479,3.915082311
14460,42.517606,-71.0219925,19740,39.434789,-104.9010728,private,37,0,497,14,14,534,548,55,0,537,0,0,592,592,3.362168135
35620,40.77493,-73.873758,38900,45.6006221,-122.484378,private,51,0,596,0,0,647,647,105,30,869,0,30,974,1004,3.618989601
31080,34.1087033,-118.1827533,40900,38.7896779,-121.0057504,private,383,0,1867,0,0,2250,2250,393,14,2515,0,14,2908,2922,4.814580795
49740,32.7739424,-113.910905,19740,39.434789,-104.9010728,private,211,364,364,0,364,575,939,176,327,421,0,327,597,924,3.569121356
38060,33.1857653,-112.0678624,43220,47.3541257,-123.1738498,private,168,260,309,0,260,477,737,171,207,293,0,207,464,671,3.411413028
34580,48.4932917,-121.8157703,49420,46.4565581,-120.7401446,private,120,0,273,0,0,393,393,101,0,265,0,0,366,366,3.221290341
49740,32.7739424,-113.910905,16980,41.8235214,-87.8282967,private,306,642,473,0,642,779,1421,273,520,533,0,520,806,1326,3.819709291
16980,41.8235214,-87.8282967,34980,36.1181822,-86.6441196,private,589,0,1174,0,0,1763,1763,706,0,1332,0,0,2038,2038,4.263536679
47900,38.7982054,-77.4868816,37980,39.8949576,-75.3119824,private,28,0,661,0,0,689,689,47,11,816,0,11,863,874,3.537953702
35620,40.77493,-73.873758,36740,28.4343962,-81.3560839,private,595,12,2312,0,12,2907,2919,826,138,3018,0,138,3844,3982,5.475335052
19100,32.8491708,-96.9704894,36420,35.4309676,-97.5069659,private,280,0,721,0,0,1001,1001,303,0,818,0,0,1121,1121,3.691921911
16980,41.8235214,-87.8282967,17460,41.7603919,-81.7242168,private,135,0,500,0,0,635,635,128,26,591,0,26,719,745,3.457541155
41860,37.7737185,-122.2744317,14460,42.517606,-71.0219925,private,85,0,711,0,0,796,796,119,13,984,0,13,1103,1116,3.688805145
35620,40.77493,-73.873758,39580,35.7567464,-78.4604412,private,209,0,950,0,0,1159,1159,301,83,1486,0,83,1787,1870,4.158813362
31080,34.1087033,-118.1827533,19740,39.434789,-104.9010728,private,261,0,1470,0,0,1731,1731,272,0,1859,0,0,2131,2131,4.321508514
37980,39.8949576,-75.3119824,45940,40.2825026,-74.703724,private,189,0,811,0,0,1000,1000,167,12,822,0,12,989,1001,3.617119542
33460,45.096664,-93.275361,32580,26.3963839,-98.18099,private,55,458,103,0,458,158,616,40,384,89,0,384,129,513,3.312923243
19100,32.8491708,-96.9704894,19740,39.434789,-104.9010728,private,289,0,1021,0,0,1310,1310,272,12,1046,0,12,1318,1330,3.822202703
19100,32.8491708,-96.9704894,30980,32.4316457,-94.6848326,private,246,0,586,0,0,832,832,242,13,619,0,13,861,874,3.537953702
26420,29.7495926,-95.3536422,12060,33.693728,-84.3999113,private,209,0,761,0,0,970,970,175,12,803,0,12,978,990,3.610262658
26420,29.7495926,-95.3536422,33100,26.1018281,-80.4787552,private,174,0,854,0,0,1028,1028,168,0,790,0,0,958,958,3.59031536
49740,32.7739424,-113.910905,29820,36.2142575,-115.013812,private,90,21,266,0,21,356,377,87,11,256,0,11,343,354,3.213810104
33460,45.096664,-93.275361,35840,27.3642461,-82.3193579,private,142,420,196,0,420,338,758,153,487,221,0,487,374,861,3.529850112
26420,29.7495926,-95.3536422,16980,41.8235214,-87.8282967,private,137,0,689,0,0,826,826,88,0,637,0,0,725,725,3.445074094
42660,47.4905993,-121.833996,16980,41.8235214,-87.8282967,private,129,0,969,0,0,1098,1098,120,14,886,0,14,1006,1020,3.628963251
35620,40.77493,-73.873758,38060,33.1857653,-112.0678624,private,65,12,489,0,12,554,566,125,76,1019,0,76,1144,1220,3.753633865
41860,37.7737185,-122.2744317,29820,36.2142575,-115.013812,private,105,0,377,0,0,482,482,120,15,555,0,15,675,690,3.423256736
33100,26.1018281,-80.4787552,23540,29.4807065,-82.6274667,private,127,0,406,0,0,533,533,143,18,487,0,18,630,648,3.397075907
12060,33.693728,-84.3999113,42340,32.1091533,-81.2731066,private,186,0,537,0,0,723,723,181,12,722,0,12,903,915,3.563511178
16980,41.8235214,-87.8282967,31540,43.0842941,-89.5971796,private,336,0,1229,0,0,1565,1565,372,124,1397,0,124,1769,1893,4.173150483
49740,32.7739424,-113.910905,40140,34.5384763,-116.1345414,private,211,79,501,0,79,712,791,227,45,625,0,45,852,897,3.552290823
19100,32.8491708,-96.9704894,38060,33.1857653,-112.0678624,private,282,14,688,0,14,970,984,232,12,679,0,12,911,923,3.568498002
47900,38.7982054,-77.4868816,31080,34.1087033,-118.1827533,private,37,0,755,0,0,792,792,59,12,865,0,12,924,936,3.576601592
34580,48.4932917,-121.8157703,17660,47.6759658,-116.6959222,private,128,12,165,0,12,293,305,163,11,187,0,11,350,361,3.218173575
14460,42.517606,-71.0219925,25540,41.7186503,-72.5739191,private,43,0,293,21,21,336,357,46,22,446,0,22,492,514,3.313546596
26420,29.7495926,-95.3536422,28660,31.2027301,-97.7896384,private,184,0,372,0,0,556,556,156,0,433,0,0,589,589,3.360298076
43220,47.3541257,-123.1738498,40140,34.5384763,-116.1345414,private,89,297,167,0,297,256,553,113,253,153,0,253,266,519,3.316663361
35620,40.77493,-73.873758,11220,42.9008912,-74.4353575,private,70,0,288,0,0,358,358,117,181,582,0,181,699,880,3.54169382
38060,33.1857653,-112.0678624,22660,40.6580933,-105.4867638,private,139,189,242,0,189,381,570,165,159,267,0,159,432,591,3.361544782
14460,42.517606,-71.0219925,12420,30.2395128,-97.6912697,private,50,0,354,17,17,404,421,53,0,371,0,0,424,424,3.257444819
14460,42.517606,-71.0219925,41740,33.0236041,-116.7761174,private,45,0,478,13,13,523,536,44,0,447,0,0,491,491,3.299209475
41860,37.7737185,-122.2744317,33100,26.1018281,-80.4787552,private,56,0,449,0,0,505,505,114,11,804,0,11,918,929,3.572238121
47900,38.7982054,-77.4868816,19740,39.434789,-104.9010728,private,37,0,399,0,0,436,436,31,0,416,0,0,447,447,3.27178194
12060,33.693728,-84.3999113,12220,32.6040644,-85.3530477,private,191,0,434,0,0,625,625,202,11,509,0,11,711,722,3.443204035
12060,33.693728,-84.3999113,31080,34.1087033,-118.1827533,private,217,0,1509,0,0,1726,1726,142,0,1220,0,0,1362,1362,3.842150001
37980,39.8949576,-75.3119824,14460,42.517606,-71.0219925,private,79,0,680,0,0,759,759,50,0,605,0,0,655,655,3.401439379
12060,33.693728,-84.3999113,37860,30.6554013,-87.1618275,private,272,39,529,0,39,801,840,284,69,531,0,69,815,884,3.544187233
41860,37.7737185,-122.2744317,17020,39.6659588,-121.6019188,private,53,0,248,0,0,301,301,88,38,469,0,38,557,595,3.364038195
35620,40.77493,-73.873758,12580,39.304361,-76.5495009,private,143,0,1043,0,0,1186,1186,212,102,1583,0,102,1795,1897,4.175643895
12060,33.693728,-84.3999113,16700,33.0180695,-80.0075006,private,229,0,568,0,0,797,797,249,42,583,0,42,832,874,3.537953702
12060,33.693728,-84.3999113,26420,29.7495926,-95.3536422,private,156,0,703,0,0,859,859,171,0,827,0,0,998,998,3.615249483
41860,37.7737185,-122.2744317,38060,33.1857653,-112.0678624,private,98,12,446,0,12,544,556,183,43,745,0,43,928,971,3.59841895
26420,29.7495926,-95.3536422,29180,29.9577733,-92.0493498,private,108,0,280,0,0,388,388,111,0,336,0,0,447,447,3.27178194
38060,33.1857653,-112.0678624,33340,43.0176601,-87.4815541,private,140,260,283,0,260,423,683,169,240,306,0,240,475,715,3.438840563
16980,41.8235214,-87.8282967,35660,41.7913818,-86.7425435,private,81,0,134,0,0,215,215,170,107,257,0,107,427,534,3.326013657
14460,42.517606,-71.0219925,35840,27.3642461,-82.3193579,private,48,66,123,100,166,171,337,49,78,125,0,78,174,252,3.150228091
49740,32.7739424,-113.910905,41740,33.0236041,-116.7761174,private,195,114,466,0,114,661,775,198,86,482,0,86,680,766,3.47063157
37980,39.8949576,-75.3119824,34940,26.118786,-81.4009553,private,42,182,60,0,182,102,284,73,262,104,0,262,177,439,3.266795115
42660,47.4905993,-121.833996,19740,39.434789,-104.9010728,private,203,0,842,0,0,1045,1045,178,0,925,0,0,1103,1103,3.680701556
34580,48.4932917,-121.8157703,46060,32.1280427,-111.7836574,private,87,189,160,0,189,247,436,90,232,189,0,232,279,511,3.311676536
47900,38.7982054,-77.4868816,42660,47.4905993,-121.833996,private,52,0,389,0,0,441,441,16,0,396,0,0,412,412,3.249964582
12060,33.693728,-84.3999113,36740,28.4343962,-81.3560839,private,566,0,1323,0,0,1889,1889,498,14,1419,0,14,1917,1931,4.1968379
38060,33.1857653,-112.0678624,38900,45.6006221,-122.484378,private,363,428,866,0,428,1229,1657,328,379,987,0,379,1315,1694,4.049103222
38060,33.1857653,-112.0678624,17820,38.8455072,-104.6387277,private,143,106,331,0,106,474,580,137,104,317,0,104,454,558,3.340974131
38060,33.1857653,-112.0678624,41860,37.7737185,-122.2744317,private,144,100,828,0,100,972,1072,110,75,746,0,75,856,931,3.573484827
19100,32.8491708,-96.9704894,16980,41.8235214,-87.8282967,private,240,13,1000,0,13,1240,1253,159,0,950,0,0,1109,1109,3.684441674
47900,38.7982054,-77.4868816,12060,33.693728,-84.3999113,private,54,0,444,0,0,498,498,48,0,594,0,0,642,642,3.393335789
35620,40.77493,-73.873758,17460,41.7603919,-81.7242168,private,49,0,336,0,0,385,385,104,69,720,0,69,824,893,3.54979741
12060,33.693728,-84.3999113,37260,29.5938964,-81.7320389,private,257,43,406,0,43,663,706,276,65,471,0,65,747,812,3.499305811
37980,39.8949576,-75.3119824,47900,38.7982054,-77.4868816,private,181,0,1392,0,0,1573,1573,115,0,1449,0,0,1564,1564,3.968067322
12060,33.693728,-84.3999113,35620,40.77493,-73.873758,private,274,13,2364,0,13,2638,2651,140,0,2046,0,0,2186,2186,4.355792933
43220,47.3541257,-123.1738498,49420,46.4565581,-120.7401446,private,87,0,237,0,0,324,324,81,13,215,0,13,296,309,3.185759216
12060,33.693728,-84.3999113,22840,34.460929,-85.803992,private,146,0,282,0,0,428,428,142,0,303,0,0,445,445,3.270535234
33460,45.096664,-93.275361,42660,47.4905993,-121.833996,private,143,0,820,0,0,963,963,69,0,572,0,0,641,641,3.392712436
37980,39.8949576,-75.3119824,12580,39.304361,-76.5495009,private,80,0,538,0,0,618,618,98,0,650,0,0,748,748,3.459411215
49740,32.7739424,-113.910905,22660,40.6580933,-105.4867638,private,68,152,80,0,152,148,300,91,121,109,0,121,200,321,3.193239453
37980,39.8949576,-75.3119824,16980,41.8235214,-87.8282967,private,55,0,478,0,0,533,533,36,0,501,0,0,537,537,3.327883716
33100,26.1018281,-80.4787552,11700,35.5956693,-82.6816145,private,69,221,194,0,221,263,484,91,254,304,0,254,395,649,3.39769926
33100,26.1018281,-80.4787552,16980,41.8235214,-87.8282967,private,241,283,811,0,283,1052,1335,227,250,862,0,250,1089,1339,3.827812881
33100,26.1018281,-80.4787552,45220,30.3864255,-84.2804096,private,117,0,392,0,0,509,509,108,0,407,0,0,515,515,3.314169949
37980,39.8949576,-75.3119824,12060,33.693728,-84.3999113,private,158,0,654,0,0,812,812,165,0,852,0,0,1017,1017,3.627093191
42660,47.4905993,-121.833996,46060,32.1280427,-111.7836574,private,193,229,387,0,229,580,809,204,304,483,0,304,687,991,3.610886011
43220,47.3541257,-123.1738498,44060,48.091618,-117.663472,private,172,22,413,0,22,585,607,240,15,472,0,15,712,727,3.4463208
49740,32.7739424,-113.910905,44060,48.091618,-117.663472,private,185,357,172,0,357,357,714,176,331,216,0,331,392,723,3.443827388
35620,40.77493,-73.873758,34980,36.1181822,-86.6441196,private,74,0,482,0,0,556,556,125,27,828,0,27,953,980,3.604029128
35620,40.77493,-73.873758,38300,40.4395249,-79.8360972,private,46,0,439,0,0,485,485,55,42,827,0,42,882,924,3.569121356
16980,41.8235214,-87.8282967,34740,43.2892579,-86.751892,private,147,43,267,0,43,414,457,169,104,332,0,104,501,605,3.370271725
47900,38.7982054,-77.4868816,33100,26.1018281,-80.4787552,private,62,21,435,0,21,497,518,107,81,605,0,81,712,793,3.487462103
35620,40.77493,-73.873758,10900,40.7893392,-75.398158,private,278,0,1102,0,0,1380,1380,399,67,1514,0,67,1913,1980,4.2273822
41860,37.7737185,-122.2744317,41500,36.240107,-121.3155723,private,70,0,260,0,0,330,330,134,48,425,0,48,559,607,3.371518431
49740,32.7739424,-113.910905,40940,32.9318277,-109.8783103,private,102,49,148,0,49,250,299,100,46,159,0,46,259,305,3.183265803
16980,41.8235214,-87.8282967,38900,45.6006221,-122.484378,private,88,0,626,0,0,714,714,63,0,553,0,0,616,616,3.377128609
34580,48.4932917,-121.8157703,28420,46.3639636,-119.2540459,private,87,12,204,0,12,291,303,102,0,186,0,0,288,288,3.172668801
14460,42.517606,-71.0219925,26420,29.7495926,-95.3536422,private,39,0,268,21,21,307,328,43,11,274,0,11,317,328,3.197602924
35620,40.77493,-73.873758,45300,28.1259071,-82.4652858,private,381,52,1663,0,52,2044,2096,496,170,2300,0,170,2796,2966,4.84200833
16980,41.8235214,-87.8282967,37980,39.8949576,-75.3119824,private,66,0,663,0,0,729,729,65,0,708,0,0,773,773,3.474995042
26420,29.7495926,-95.3536422,35380,29.805532,-89.7013821,private,161,0,606,0,0,767,767,179,0,623,0,0,802,802,3.493072281
47900,38.7982054,-77.4868816,40060,37.4113241,-77.4418164,private,36,0,327,0,0,363,363,35,0,426,0,0,461,461,3.280508883
42660,47.4905993,-121.833996,25720,40.6913977,-111.0527658,private,158,0,253,0,0,411,411,187,47,288,0,47,475,522,3.31853342
43220,47.3541257,-123.1738498,28420,46.3639636,-119.2540459,private,84,0,143,0,0,227,227,85,12,203,0,12,288,300,3.180149038
12060,33.693728,-84.3999113,15980,26.5590348,-81.8919943,private,183,93,315,0,93,498,591,176,112,351,0,112,527,639,3.39146573
38060,33.1857653,-112.0678624,10740,35.1234965,-106.4583918,private,149,28,430,0,28,579,607,148,26,480,0,26,628,654,3.400816026
49740,32.7739424,-113.910905,33540,47.0272632,-113.8926911,private,51,172,75,0,172,126,298,71,150,71,0,150,142,292,3.175162213
12060,33.693728,-84.3999113,45300,28.1259071,-82.4652858,private,658,77,1730,0,77,2388,2465,606,100,1736,0,100,2342,2442,4.51537132
12060,33.693728,-84.3999113,48180,31.1331137,-82.3686504,private,242,0,498,0,0,740,740,264,63,565,0,63,829,892,3.549174057
35620,40.77493,-73.873758,35980,41.4726517,-72.1086339,private,14,0,138,0,0,152,152,52,138,354,0,138,406,544,3.332247188
14460,42.517606,-71.0219925,35300,41.3497185,-72.9002033,private,48,0,368,29,29,416,445,53,17,440,0,17,493,510,3.311053183
37980,39.8949576,-75.3119824,25420,40.335915,-77.0504897,private,132,0,499,0,0,631,631,132,0,595,0,0,727,727,3.4463208
41860,37.7737185,-122.2744317,26420,29.7495926,-95.3536422,private,60,0,273,0,0,333,333,68,0,420,0,0,488,488,3.297339416
38060,33.1857653,-112.0678624,19820,42.7218478,-83.2008463,private,229,333,480,0,333,709,1042,227,246,550,0,246,777,1023,3.63083331
33460,45.096664,-93.275361,19740,39.434789,-104.9010728,private,138,0,888,0,0,1026,1026,171,0,784,0,0,955,955,3.588445301
49740,32.7739424,-113.910905,17820,38.8455072,-104.6387277,private,94,79,116,0,79,210,289,69,79,116,0,79,185,264,3.157708327
12060,33.693728,-84.3999113,12260,33.4603713,-81.9828327,private,318,0,834,0,0,1152,1152,315,0,1039,0,0,1354,1354,3.837163177
16980,41.8235214,-87.8282967,14010,40.4945594,-88.8445391,private,177,0,625,0,0,802,802,178,0,733,0,0,911,911,3.561017766
14460,42.517606,-71.0219925,12060,33.693728,-84.3999113,private,119,0,501,37,37,620,657,108,0,569,0,0,677,677,3.415153147
20900,29.2784805,-96.2296745,47020,28.7314546,-97.1969934,private,88,0,167,0,0,255,255,115,0,168,0,0,283,283,3.169552036
12060,33.693728,-84.3999113,10500,31.6444531,-84.1119078,private,199,0,538,0,0,737,737,192,0,645,0,0,837,837,3.514889638
37980,39.8949576,-75.3119824,31080,34.1087033,-118.1827533,private,44,26,679,0,26,723,749,29,0,647,0,0,676,676,3.414529793
16980,41.8235214,-87.8282967,45300,28.1259071,-82.4652858,private,726,552,1562,0,552,2288,2840,713,668,1680,0,668,2393,3061,4.901226872
47900,38.7982054,-77.4868816,41860,37.7737185,-122.2744317,private,72,0,695,0,0,767,767,16,0,572,0,0,588,588,3.359674723
12060,33.693728,-84.3999113,13820,33.4025986,-86.7295151,private,316,0,809,0,0,1125,1125,316,0,877,0,0,1193,1193,3.736803332
35620,40.77493,-73.873758,24020,43.4404503,-73.6367573,private,26,11,163,0,11,189,200,50,158,364,0,158,414,572,3.349701074
16980,41.8235214,-87.8282967,24340,43.0375977,-85.7781669,private,111,0,365,0,0,476,476,115,11,512,0,11,627,638,3.390842377
41860,37.7737185,-122.2744317,42200,34.5370572,-120.0399729,private,41,0,158,0,0,199,199,77,0,325,0,0,402,402,3.243731051
31080,34.1087033,-118.1827533,29420,35.717705,-113.7496891,private,204,0,533,0,0,737,737,225,13,554,0,13,779,792,3.48683875
43220,47.3541257,-123.1738498,17660,47.6759658,-116.6959222,private,98,0,100,0,0,198,198,115,13,149,0,13,264,277,3.165811917
49740,32.7739424,-113.910905,14660,46.7672909,-94.2238624,private,48,177,51,0,177,99,276,53,163,40,0,163,93,256,3.152721503
35620,40.77493,-73.873758,44140,42.3648332,-72.6194063,private,12,0,283,0,0,295,295,47,99,623,0,99,670,769,3.472501629
38060,33.1857653,-112.0678624,14660,46.7672909,-94.2238624,private,95,281,92,0,281,187,468,108,287,72,0,287,180,467,3.284249001
35620,40.77493,-73.873758,33460,45.096664,-93.275361,private,48,0,496,0,0,544,544,64,48,970,0,48,1034,1082,3.667611141
19100,32.8491708,-96.9704894,31180,33.4703271,-101.6488249,private,88,0,351,0,0,439,439,109,0,351,0,0,460,460,3.27988553
49740,32.7739424,-113.910905,28060,48.3146779,-114.0542951,private,61,143,46,0,143,107,250,71,159,44,0,159,115,274,3.163941858
16980,41.8235214,-87.8282967,16740,35.1663423,-80.7972848,private,380,0,753,0,0,1133,1133,336,0,726,0,0,1062,1062,3.65514408
14460,42.517606,-71.0219925,14860,41.2274128,-73.3670614,private,33,0,245,11,11,278,289,32,14,382,0,14,414,428,3.259938231
35620,40.77493,-73.873758,40060,37.4113241,-77.4418164,private,34,0,612,0,0,646,646,113,37,948,0,37,1061,1098,3.67758479
19100,32.8491708,-96.9704894,21340,31.527394,-105.5213326,private,83,0,322,0,0,405,405,104,0,351,0,0,455,455,3.276768764
12060,33.693728,-84.3999113,39580,35.7567464,-78.4604412,private,234,0,623,0,0,857,857,239,0,739,0,0,978,978,3.602782421
12060,33.693728,-84.3999113,34980,36.1181822,-86.6441196,private,426,0,1159,0,0,1585,1585,389,0,1105,0,0,1494,1494,3.924432607
38060,33.1857653,-112.0678624,17660,47.6759658,-116.6959222,private,99,206,126,0,206,225,431,116,181,171,0,181,287,468,3.284872354
31080,34.1087033,-118.1827533,14460,42.517606,-71.0219925,private,31,0,866,0,0,897,897,35,0,900,0,0,935,935,3.575978239
42660,47.4905993,-121.833996,14460,42.517606,-71.0219925,private,76,0,558,0,0,634,634,59,0,524,0,0,583,583,3.356557958
33100,26.1018281,-80.4787552,16740,35.1663423,-80.7972848,private,206,17,596,0,17,802,819,240,37,635,0,37,875,912,3.561641119
33100,26.1018281,-80.4787552,19100,32.8491708,-96.9704894,private,277,0,811,0,0,1088,1088,223,0,889,0,0,1112,1112,3.686311733
35620,40.77493,-73.873758,11460,42.2522168,-83.8434233,private,38,0,321,0,0,359,359,50,44,498,0,44,548,592,3.362168135
47900,38.7982054,-77.4868816,41540,38.3995211,-75.4782615,private,20,0,108,0,0,128,128,40,79,196,0,79,236,315,3.189499334
34580,48.4932917,-121.8157703,41740,33.0236041,-116.7761174,private,142,77,237,0,77,379,456,128,58,339,0,58,467,525,3.320403479
12060,33.693728,-84.3999113,42660,47.4905993,-121.833996,private,169,0,901,0,0,1070,1070,99,0,685,0,0,784,784,3.481851925
16980,41.8235214,-87.8282967,18140,39.9685617,-82.8359105,private,149,0,556,0,0,705,705,157,0,622,0,0,779,779,3.47873516
49740,32.7739424,-113.910905,33340,43.0176601,-87.4815541,private,83,160,98,0,160,181,341,77,136,150,0,136,227,363,3.219420282
26420,29.7495926,-95.3536422,42660,47.4905993,-121.833996,private,106,0,559,0,0,665,665,99,17,483,0,17,582,599,3.366531607
14460,42.517606,-71.0219925,39580,35.7567464,-78.4604412,private,37,0,244,0,0,281,281,66,15,337,0,15,403,418,3.253704701
38060,33.1857653,-112.0678624,11460,42.2522168,-83.8434233,private,100,136,201,0,136,301,437,100,126,230,0,126,330,456,3.277392117
12060,33.693728,-84.3999113,25940,32.3867916,-80.8308775,private,183,15,223,0,15,406,421,236,81,249,0,81,485,566,3.345960955
14460,42.517606,-71.0219925,15980,26.5590348,-81.8919943,private,29,63,91,80,143,120,263,36,75,120,0,75,156,231,3.137137676
31080,34.1087033,-118.1827533,46060,32.1280427,-111.7836574,private,142,0,693,0,0,835,835,147,0,793,0,0,940,940,3.579095005
19100,32.8491708,-96.9704894,31080,34.1087033,-118.1827533,private,290,24,1404,0,24,1694,1718,219,17,1303,0,17,1522,1539,3.952483495
33100,26.1018281,-80.4787552,12420,30.2395128,-97.6912697,private,115,0,443,0,0,558,558,108,11,499,0,11,607,618,3.378375315
37980,39.8949576,-75.3119824,35840,27.3642461,-82.3193579,private,72,117,152,0,117,224,341,91,130,183,0,130,274,404,3.244977758
12060,33.693728,-84.3999113,25980,31.7787881,-81.5764801,private,203,0,439,0,0,642,642,197,0,495,0,0,692,692,3.424503443
35620,40.77493,-73.873758,25720,40.6913977,-111.0527658,private,34,0,97,0,0,131,131,80,51,222,0,51,302,353,3.213186751
41860,37.7737185,-122.2744317,42020,35.3852242,-120.4475445,private,47,0,211,0,0,258,258,77,34,357,0,34,434,468,3.284872354
47900,38.7982054,-77.4868816,12420,30.2395128,-97.6912697,private,33,0,246,0,0,279,279,28,0,277,0,0,305,305,3.183265803
19100,32.8491708,-96.9704894,41860,37.7737185,-122.2744317,private,147,0,678,0,0,825,825,80,0,532,0,0,612,612,3.374635197
38060,33.1857653,-112.0678624,29420,35.717705,-113.7496891,private,92,0,333,0,0,425,425,128,0,414,0,0,542,542,3.331000482
26420,29.7495926,-95.3536422,41860,37.7737185,-122.2744317,private,109,14,517,0,14,626,640,58,14,394,0,14,452,466,3.283625648
49740,32.7739424,-113.910905,48580,42.6681095,-88.5417306,private,48,152,55,0,152,103,255,47,141,54,0,141,101,242,3.14399456
49740,32.7739424,-113.910905,39660,44.3154852,-102.7683833,private,58,136,59,0,136,117,253,78,118,43,0,118,121,239,3.142124501
19100,32.8491708,-96.9704894,22220,36.1163935,-94.0795449,private,141,0,263,0,0,404,404,126,0,268,0,0,394,394,3.238744227
16980,41.8235214,-87.8282967,17140,39.0998213,-84.4804072,private,111,0,432,0,0,543,543,77,0,493,0,0,570,570,3.348454368
19100,32.8491708,-96.9704894,32580,26.3963839,-98.18099,private,131,19,268,0,19,399,418,92,35,322,0,35,414,449,3.273028646
38060,33.1857653,-112.0678624,12420,30.2395128,-97.6912697,private,208,0,508,0,0,716,716,144,0,493,0,0,637,637,3.390219024
12060,33.693728,-84.3999113,12420,30.2395128,-97.6912697,private,165,0,569,0,0,734,734,166,0,584,0,0,750,750,3.460657921
38060,33.1857653,-112.0678624,13900,46.887031,-100.979592,private,116,182,63,0,182,179,361,141,170,106,0,170,247,417,3.253081348
34580,48.4932917,-121.8157703,14260,43.0066485,-116.1419089,private,121,0,160,0,0,281,281,124,16,223,0,16,347,363,3.219420282
14460,42.517606,-71.0219925,15540,44.6891168,-73.0411707,private,19,0,159,0,0,178,178,24,18,221,0,18,245,263,3.157084974
37980,39.8949576,-75.3119824,39740,40.4139565,-75.9268598,private,138,0,491,0,0,629,629,184,0,616,0,0,800,800,3.491825574
33100,26.1018281,-80.4787552,29820,36.2142575,-115.013812,private,82,0,332,0,0,414,414,71,0,355,0,0,426,426,3.258691525
16980,41.8235214,-87.8282967,44100,39.828565,-89.6962052,private,43,0,307,0,0,350,350,67,0,403,0,0,470,470,3.28611906
33460,45.096664,-93.275361,46060,32.1280427,-111.7836574,private,137,527,231,0,527,368,895,110,558,286,0,558,396,954,3.587821948
16980,41.8235214,-87.8282967,46060,32.1280427,-111.7836574,private,226,270,447,0,270,673,943,212,339,523,0,339,735,1074,3.662624316
31080,34.1087033,-118.1827533,14260,43.0066485,-116.1419089,private,186,0,500,0,0,686,686,407,0,731,0,0,1138,1138,3.702518913
41860,37.7737185,-122.2744317,46520,21.5800225,-158.1234063,private,13,0,137,0,0,150,150,47,33,269,0,33,316,349,3.210693339
49740,32.7739424,-113.910905,28420,46.3639636,-119.2540459,private,68,120,57,0,120,125,245,79,90,75,0,90,154,244,3.145241266
41860,37.7737185,-122.2744317,47900,38.7982054,-77.4868816,private,66,0,748,0,0,814,814,111,0,945,0,0,1056,1056,3.651403961
12060,33.693728,-84.3999113,47900,38.7982054,-77.4868816,private,368,12,1923,0,12,2291,2303,263,0,1646,0,0,1909,1909,4.183124132
31080,34.1087033,-118.1827533,46380,39.4323876,-123.4428811,private,31,0,349,0,0,380,380,39,0,459,0,0,498,498,3.303572946
12060,33.693728,-84.3999113,19740,39.434789,-104.9010728,private,210,0,867,0,0,1077,1077,185,13,796,0,13,981,994,3.612756071
26420,29.7495926,-95.3536422,18580,27.8335972,-97.5089575,private,94,0,275,0,0,369,369,113,0,298,0,0,411,411,3.249341229
33100,26.1018281,-80.4787552,31080,34.1087033,-118.1827533,private,134,0,822,0,0,956,956,66,0,820,0,0,886,886,3.545433939
49740,32.7739424,-113.910905,31080,34.1087033,-118.1827533,private,195,59,711,0,59,906,965,163,47,777,0,47,940,987,3.608392599
42660,47.4905993,-121.833996,41940,36.9084718,-121.3713721,private,169,0,776,0,0,945,945,126,12,628,0,12,754,766,3.47063157
38060,33.1857653,-112.0678624,14260,43.0066485,-116.1419089,private,203,146,293,0,146,496,642,235,153,332,0,153,567,720,3.441957329
35620,40.77493,-73.873758,38860,43.6514172,-70.4183755,private,13,0,218,0,0,231,231,93,184,642,0,184,735,919,3.56600459
31080,34.1087033,-118.1827533,25720,40.6913977,-111.0527658,private,219,11,464,0,11,683,694,339,60,726,0,60,1065,1125,3.694415323
14460,42.517606,-71.0219925,38340,42.371493,-73.2179276,private,15,15,90,24,39,105,144,27,48,162,0,48,189,237,3.140877794
37980,39.8949576,-75.3119824,38300,40.4395249,-79.8360972,private,35,0,360,0,0,395,395,54,0,484,0,0,538,538,3.328507069
33100,26.1018281,-80.4787552,39580,35.7567464,-78.4604412,private,130,13,404,0,13,534,547,165,13,441,0,13,606,619,3.378998668
16980,41.8235214,-87.8282967,41700,29.4330599,-98.6069734,private,172,0,500,0,0,672,672,183,0,521,0,0,704,704,3.431983679
33100,26.1018281,-80.4787552,14460,42.517606,-71.0219925,private,157,292,599,0,292,756,1048,162,266,676,0,266,838,1104,3.681324909
47900,38.7982054,-77.4868816,16820,37.9490837,-78.5932062,private,25,0,106,0,0,131,131,26,15,195,0,15,221,236,3.140254441
19100,32.8491708,-96.9704894,46140,36.2544287,-96.1773294,private,171,0,462,0,0,633,633,171,0,515,0,0,686,686,3.420763324
14460,42.517606,-71.0219925,19100,32.8491708,-96.9704894,private,88,0,363,0,0,451,451,75,13,388,0,13,463,476,3.289859179
26420,29.7495926,-95.3536422,31080,34.1087033,-118.1827533,private,130,0,805,0,0,935,935,137,15,804,0,15,941,956,3.589068654
14460,42.517606,-71.0219925,16740,35.1663423,-80.7972848,private,45,0,219,0,0,264,264,40,0,287,0,0,327,327,3.196979571
35620,40.77493,-73.873758,18500,42.2667252,-77.3855253,private,13,0,236,0,0,249,249,42,64,370,0,64,412,476,3.289859179
33460,45.096664,-93.275361,20740,44.9386719,-91.2843222,private,94,0,387,0,0,481,481,117,16,460,0,16,577,593,3.362791488
31080,34.1087033,-118.1827533,34980,36.1181822,-86.6441196,private,214,0,767,0,0,981,981,273,0,1067,0,0,1340,1340,3.828436234
33100,26.1018281,-80.4787552,20900,29.2784805,-96.2296745,private,86,0,277,0,0,363,363,115,0,309,0,0,424,424,3.257444819
16980,41.8235214,-87.8282967,37260,29.5938964,-81.7320389,private,203,268,267,0,268,470,738,193,311,304,0,311,497,808,3.496812399
12060,33.693728,-84.3999113,37340,28.2983112,-80.7003334,private,157,40,297,0,40,454,494,141,46,343,0,46,484,530,3.323520245
33460,45.096664,-93.275361,19100,32.8491708,-96.9704894,private,243,17,810,0,17,1053,1070,205,11,750,0,11,955,966,3.595302185
14460,42.517606,-71.0219925,38900,45.6006221,-122.484378,private,25,0,275,0,0,300,300,0,0,222,0,0,222,222,3.131527498
41860,37.7737185,-122.2744317,12060,33.693728,-84.3999113,private,77,0,366,0,0,443,443,85,0,586,0,0,671,671,3.411413028
12060,33.693728,-84.3999113,11700,35.5956693,-82.6816145,private,165,47,397,0,47,562,609,216,121,442,0,121,658,779,3.47873516
38060,33.1857653,-112.0678624,48580,42.6681095,-88.5417306,private,91,153,120,0,153,211,364,85,126,140,0,126,225,351,3.211940045
35620,40.77493,-73.873758,19820,42.7218478,-83.2008463,private,37,0,467,0,0,504,504,83,55,818,0,55,901,956,3.589068654
49740,32.7739424,-113.910905,36260,41.276061,-113.126226,private,51,215,67,0,215,118,333,50,104,54,0,104,104,208,3.122800555
38060,33.1857653,-112.0678624,40140,34.5384763,-116.1345414,private,226,0,715,0,0,941,941,227,28,844,0,28,1071,1099,3.678208143
31080,34.1087033,-118.1827533,47900,38.7982054,-77.4868816,private,77,0,1307,0,0,1384,1384,123,15,1499,0,15,1622,1637,4.013572096
43220,47.3541257,-123.1738498,46060,32.1280427,-111.7836574,private,85,136,162,0,136,247,383,90,151,157,0,151,247,398,3.241237639
41860,37.7737185,-122.2744317,19100,32.8491708,-96.9704894,private,105,0,469,0,0,574,574,169,0,735,0,0,904,904,3.556654294
34580,48.4932917,-121.8157703,10540,44.4888982,-122.5372084,private,39,0,134,0,0,173,173,49,0,176,0,0,225,225,3.133397558
16980,41.8235214,-87.8282967,36740,28.4343962,-81.3560839,private,421,170,962,0,170,1383,1553,375,188,983,0,188,1358,1546,3.956846967
38060,33.1857653,-112.0678624,10140,47.1137324,-123.8267349,private,108,180,178,0,180,286,466,112,168,180,0,168,292,460,3.27988553
35620,40.77493,-73.873758,29820,36.2142575,-115.013812,private,78,0,441,0,0,519,519,88,0,565,0,0,653,653,3.400192673
19100,32.8491708,-96.9704894,29820,36.2142575,-115.013812,private,105,0,304,0,0,409,409,85,0,312,0,0,397,397,3.240614286
33460,45.096664,-93.275361,12420,30.2395128,-97.6912697,private,157,29,422,0,29,579,608,106,40,412,0,40,518,558,3.340974131
43220,47.3541257,-123.1738498,14260,43.0066485,-116.1419089,private,86,0,139,0,0,225,225,118,0,202,0,0,320,320,3.1926161
31080,34.1087033,-118.1827533,23420,36.7610058,-119.6550193,private,80,0,532,0,0,612,612,103,0,622,0,0,725,725,3.445074094
26420,29.7495926,-95.3536422,29820,36.2142575,-115.013812,private,40,0,219,0,0,259,259,41,0,227,0,0,268,268,3.16020174
38060,33.1857653,-112.0678624,40340,43.9496362,-92.3360701,private,124,110,126,0,110,250,360,133,121,115,0,121,248,369,3.2231604
19100,32.8491708,-96.9704894,16740,35.1663423,-80.7972848,private,151,0,362,0,0,513,513,127,0,340,0,0,467,467,3.284249001
37980,39.8949576,-75.3119824,29540,40.0419921,-76.250198,private,106,0,418,0,0,524,524,143,0,508,0,0,651,651,3.398945967
49740,32.7739424,-113.910905,40900,38.7896779,-121.0057504,private,68,79,162,0,79,230,309,77,60,178,0,60,255,315,3.189499334
35620,40.77493,-73.873758,40380,43.148038,-77.5232575,private,12,0,479,0,0,491,491,55,82,900,0,82,955,1037,3.639560253
16980,41.8235214,-87.8282967,40140,34.5384763,-116.1345414,private,113,180,391,0,180,504,684,105,254,449,0,254,554,808,3.496812399
19100,32.8491708,-96.9704894,17820,38.8455072,-104.6387277,private,92,0,224,0,0,316,316,98,0,247,0,0,345,345,3.208199926
19100,32.8491708,-96.9704894,35620,40.77493,-73.873758,private,128,0,1005,0,0,1133,1133,47,0,718,0,0,765,765,3.470008217
33100,26.1018281,-80.4787552,37860,30.6554013,-87.1618275,private,71,17,231,0,17,302,319,95,16,242,0,16,337,353,3.213186751
42660,47.4905993,-121.833996,26420,29.7495926,-95.3536422,private,82,30,369,0,30,451,481,84,29,387,0,29,471,500,3.304819653
19100,32.8491708,-96.9704894,17780,30.7543917,-96.4885368,private,105,0,309,0,0,414,414,94,0,240,0,0,334,334,3.201343043
19100,32.8491708,-96.9704894,25720,40.6913977,-111.0527658,private,110,0,160,0,0,270,270,112,31,172,0,31,284,315,3.189499334
26420,29.7495926,-95.3536422,47020,28.7314546,-97.1969934,private,75,0,230,0,0,305,305,85,11,268,0,11,353,364,3.220043635
41860,37.7737185,-122.2744317,39900,40.5007953,-119.7311608,private,37,0,199,0,0,236,236,88,0,271,0,0,359,359,3.216926869
26420,29.7495926,-95.3536422,12940,30.5187808,-91.1255901,private,103,0,306,0,0,409,409,97,0,333,0,0,430,430,3.261184938
38060,33.1857653,-112.0678624,36540,41.2904587,-95.9999701,private,102,140,193,0,140,295,435,123,108,202,0,108,325,433,3.263054997
31080,34.1087033,-118.1827533,33700,37.5623162,-121.0028311,private,123,0,462,0,0,585,585,116,0,693,0,0,809,809,3.497435752
38060,33.1857653,-112.0678624,12060,33.693728,-84.3999113,private,201,0,602,0,0,803,803,195,11,608,0,11,803,814,3.500552517
35620,40.77493,-73.873758,15540,44.6891168,-73.0411707,private,0,0,128,0,0,128,128,20,53,323,0,53,343,396,3.239990933
26420,29.7495926,-95.3536422,28780,27.1139432,-97.5685077,private,81,0,201,0,0,282,282,111,0,265,0,0,376,376,3.227523872
49740,32.7739424,-113.910905,19100,32.8491708,-96.9704894,private,172,0,329,0,0,501,501,166,0,370,0,0,536,536,3.327260363
37980,39.8949576,-75.3119824,15980,26.5590348,-81.8919943,private,52,94,124,0,94,176,270,64,113,146,0,113,210,323,3.194486159
49740,32.7739424,-113.910905,41860,37.7737185,-122.2744317,private,67,51,182,0,51,249,300,46,47,207,0,47,253,300,3.180149038
35620,40.77493,-73.873758,41180,38.7402108,-90.3458253,private,22,0,213,0,0,235,235,37,16,467,0,16,504,520,3.317286714
41860,37.7737185,-122.2744317,37100,34.3587415,-119.1331432,private,27,0,138,0,0,165,165,31,0,250,0,0,281,281,3.16830533
47900,38.7982054,-77.4868816,41740,33.0236041,-116.7761174,private,36,0,234,0,0,270,270,33,0,286,0,0,319,319,3.191992746
33100,26.1018281,-80.4787552,31140,38.3058381,-85.6816455,private,51,12,320,0,12,371,383,42,20,324,0,20,366,386,3.233757402
41860,37.7737185,-122.2744317,37980,39.8949576,-75.3119824,private,23,0,366,0,0,389,389,26,0,619,0,0,645,645,3.395205848
12060,33.693728,-84.3999113,14460,42.517606,-71.0219925,private,68,0,511,0,0,579,579,49,0,474,0,0,523,523,3.319156773
33100,26.1018281,-80.4787552,12100,39.4693555,-74.6337591,private,42,178,53,0,178,95,273,21,129,58,0,129,79,208,3.122800555
16980,41.8235214,-87.8282967,37900,40.7088872,-89.6974658,private,126,0,436,0,0,562,562,150,0,599,0,0,749,749,3.460034568
33100,26.1018281,-80.4787552,37980,39.8949576,-75.3119824,private,144,225,516,0,225,660,885,165,180,619,0,180,784,964,3.594055478
49740,32.7739424,-113.910905,36540,41.2904587,-95.9999701,private,46,104,65,0,104,111,215,57,80,74,0,80,131,211,3.124670615
35620,40.77493,-73.873758,15980,26.5590348,-81.8919943,private,106,58,343,0,58,449,507,119,135,503,0,135,622,757,3.465021392
33100,26.1018281,-80.4787552,19740,39.434789,-104.9010728,private,102,11,457,0,11,559,570,120,29,522,0,29,642,671,3.411413028
37980,39.8949576,-75.3119824,42660,47.4905993,-121.833996,private,46,0,382,0,0,428,428,34,0,326,0,0,360,360,3.217550222
38060,33.1857653,-112.0678624,40700,43.2863277,-123.154476,private,86,125,208,0,125,294,419,93,105,219,0,105,312,417,3.253081348
35620,40.77493,-73.873758,12100,39.4693555,-74.6337591,private,0,0,136,0,0,136,136,58,144,341,0,144,399,543,3.331623835
35620,40.77493,-73.873758,20500,36.0605886,-78.9897875,private,25,0,220,0,0,245,245,50,13,385,0,13,435,448,3.272405293
47900,38.7982054,-77.4868816,26420,29.7495926,-95.3536422,private,29,0,152,0,0,181,181,28,0,188,0,0,216,216,3.12778738
26420,29.7495926,-95.3536422,21340,31.527394,-105.5213326,private,59,0,204,0,0,263,263,68,0,209,0,0,277,277,3.165811917
41860,37.7737185,-122.2744317,25720,40.6913977,-111.0527658,private,57,0,118,0,0,175,175,111,25,250,0,25,361,386,3.233757402
26420,29.7495926,-95.3536422,35620,40.77493,-73.873758,private,118,0,854,0,0,972,972,65,0,658,0,0,723,723,3.443827388
35620,40.77493,-73.873758,27260,30.2365943,-81.7544462,private,63,0,457,0,0,520,520,132,53,762,0,53,894,947,3.583458476
19100,32.8491708,-96.9704894,11620,34.1258229,-97.2639184,private,68,0,125,0,0,193,193,72,0,181,0,0,253,253,3.150851444
19100,32.8491708,-96.9704894,47900,38.7982054,-77.4868816,private,188,0,875,0,0,1063,1063,82,0,736,0,0,818,818,3.50304593
49740,32.7739424,-113.910905,43620,43.4954205,-96.9953387,private,87,154,50,0,154,137,291,83,114,50,0,114,133,247,3.147111325
14460,42.517606,-71.0219925,11460,42.2522168,-83.8434233,private,17,0,107,12,12,124,136,28,0,189,0,0,217,217,3.128410733
42660,47.4905993,-121.833996,10540,44.4888982,-122.5372084,private,114,0,320,0,0,434,434,102,0,357,0,0,459,459,3.279262177
42660,47.4905993,-121.833996,33460,45.096664,-93.275361,private,132,0,464,0,0,596,596,105,0,491,0,0,596,596,3.364661548
26420,29.7495926,-95.3536422,38060,33.1857653,-112.0678624,private,110,0,385,0,0,495,495,75,0,327,0,0,402,402,3.243731051
35620,40.77493,-73.873758,37340,28.2983112,-80.7003334,private,48,0,251,0,0,299,299,99,67,391,0,67,490,557,3.340350778
35620,40.77493,-73.873758,41940,36.9084718,-121.3713721,private,45,0,599,0,0,644,644,58,0,745,0,0,803,803,3.493695634
38060,33.1857653,-112.0678624,10540,44.4888982,-122.5372084,private,102,107,182,0,107,284,391,91,107,228,0,107,319,426,3.258691525
47900,38.7982054,-77.4868816,20660,38.7483486,-76.1784757,private,17,0,26,0,0,43,43,35,61,102,0,61,137,198,3.116567025
33100,26.1018281,-80.4787552,39300,41.7068313,-71.2866369,private,70,166,187,0,166,257,423,65,137,251,0,137,316,453,3.275522058
33460,45.096664,-93.275361,37260,29.5938964,-81.7320389,private,84,202,109,0,202,193,395,76,204,93,0,204,169,373,3.225653812
38060,33.1857653,-112.0678624,41620,40.5728869,-112.9532527,private,69,31,217,0,31,286,317,70,19,219,0,19,289,308,3.185135863
12060,33.693728,-84.3999113,29460,27.9536488,-81.6935337,private,144,0,286,0,0,430,430,128,0,346,0,0,474,474,3.288612473
16980,41.8235214,-87.8282967,38300,40.4395249,-79.8360972,private,32,0,296,0,0,328,328,20,0,336,0,0,356,356,3.21505681
38060,33.1857653,-112.0678624,43620,43.4954205,-96.9953387,private,134,173,134,0,173,268,441,130,167,161,0,167,291,458,3.278638824
12060,33.693728,-84.3999113,41860,37.7737185,-122.2744317,private,112,0,777,0,0,889,889,96,0,574,0,0,670,670,3.410789675
35620,40.77493,-73.873758,17140,39.0998213,-84.4804072,private,35,0,269,0,0,304,304,129,17,539,0,17,668,685,3.420139971
33460,45.096664,-93.275361,40140,34.5384763,-116.1345414,private,28,308,167,0,308,195,503,36,332,160,0,332,196,528,3.322273539
16980,41.8235214,-87.8282967,31140,38.3058381,-85.6816455,private,47,0,270,0,0,317,317,67,0,389,0,0,456,456,3.277392117
16980,41.8235214,-87.8282967,15620,44.3287385,-85.3264287,private,51,69,125,0,69,176,245,83,131,190,0,131,273,404,3.244977758
26420,29.7495926,-95.3536422,46340,32.3770156,-95.2700409,private,119,0,247,0,0,366,366,132,0,250,0,0,382,382,3.23126399
49740,32.7739424,-113.910905,11460,42.2522168,-83.8434233,private,49,90,55,0,90,104,194,53,63,54,0,63,107,170,3.099113139
34580,48.4932917,-121.8157703,29820,36.2142575,-115.013812,private,55,14,117,0,14,172,186,43,16,135,0,16,178,194,3.114073612
33460,45.096664,-93.275361,29820,36.2142575,-115.013812,private,83,21,312,0,21,395,416,69,14,268,0,14,337,351,3.211940045
26420,29.7495926,-95.3536422,14460,42.517606,-71.0219925,private,62,0,273,0,0,335,335,37,0,306,0,0,343,343,3.20695322
26420,29.7495926,-95.3536422,41740,33.0236041,-116.7761174,private,99,0,305,0,0,404,404,60,16,289,0,16,349,365,3.220666988
31080,34.1087033,-118.1827533,37980,39.8949576,-75.3119824,private,19,0,623,0,0,642,642,26,0,775,0,0,801,801,3.492448928
47900,38.7982054,-77.4868816,39580,35.7567464,-78.4604412,private,46,0,248,0,0,294,294,45,0,304,0,0,349,349,3.210693339
16980,41.8235214,-87.8282967,38500,41.3250032,-86.2690363,private,109,0,256,0,0,365,365,116,26,326,0,26,442,468,3.284872354
19100,32.8491708,-96.9704894,49740,32.7739424,-113.910905,private,103,0,172,0,0,275,275,91,0,207,0,0,298,298,3.178902332
38060,33.1857653,-112.0678624,31540,43.0842941,-89.5971796,private,109,202,201,0,202,310,512,130,191,215,0,191,345,536,3.327260363
12060,33.693728,-84.3999113,29820,36.2142575,-115.013812,private,94,0,390,0,0,484,484,98,0,359,0,0,457,457,3.27801547
12060,33.693728,-84.3999113,38060,33.1857653,-112.0678624,private,187,11,575,0,11,762,773,167,0,557,0,0,724,724,3.444450741
14460,42.517606,-71.0219925,45300,28.1259071,-82.4652858,private,71,34,288,94,128,359,487,62,35,333,0,35,395,430,3.261184938
35620,40.77493,-73.873758,16820,37.9490837,-78.5932062,private,0,0,109,0,0,109,109,16,50,255,0,50,271,321,3.193239453
14460,42.517606,-71.0219925,12580,39.304361,-76.5495009,private,0,0,240,13,13,240,253,12,0,305,0,0,317,317,3.19074604
38060,33.1857653,-112.0678624,39660,44.3154852,-102.7683833,private,82,203,109,0,203,191,394,121,138,133,0,138,254,392,3.237497521
31080,34.1087033,-118.1827533,41700,29.4330599,-98.6069734,private,178,0,599,0,0,777,777,149,0,741,0,0,890,890,3.547927351
26420,29.7495926,-95.3536422,29340,29.9787547,-93.2532434,private,69,0,243,0,0,312,312,76,0,243,0,0,319,319,3.191992746
37980,39.8949576,-75.3119824,26420,29.7495926,-95.3536422,private,51,0,230,0,0,281,281,25,0,243,0,0,268,268,3.16020174
33100,26.1018281,-80.4787552,47900,38.7982054,-77.4868816,private,270,125,1103,0,125,1373,1498,253,133,1062,0,133,1315,1448,3.895758366
26420,29.7495926,-95.3536422,30980,32.4316457,-94.6848326,private,61,0,196,0,0,257,257,96,0,245,0,0,341,341,3.205706514
38060,33.1857653,-112.0678624,26420,29.7495926,-95.3536422,private,75,0,335,0,0,410,410,65,0,379,0,0,444,444,3.269911881
38060,33.1857653,-112.0678624,41700,29.4330599,-98.6069734,private,99,11,267,0,11,366,377,114,13,352,0,13,466,479,3.291729238
19100,32.8491708,-96.9704894,34980,36.1181822,-86.6441196,private,192,0,452,0,0,644,644,170,0,391,0,0,561,561,3.34284419
43220,47.3541257,-123.1738498,29820,36.2142575,-115.013812,private,55,17,95,0,17,150,167,59,17,112,0,17,171,188,3.110333494
38060,33.1857653,-112.0678624,41940,36.9084718,-121.3713721,private,63,33,371,0,33,434,467,51,30,288,0,30,339,369,3.2231604
14460,42.517606,-71.0219925,35980,41.4726517,-72.1086339,private,16,0,96,0,0,112,112,30,15,142,0,15,172,187,3.109710141
35620,40.77493,-73.873758,41540,38.3995211,-75.4782615,private,38,0,240,0,0,278,278,63,80,461,0,80,524,604,3.369648372
20900,29.2784805,-96.2296745,32580,26.3963839,-98.18099,private,41,0,99,0,0,140,140,72,0,114,0,0,186,186,3.109086788
49740,32.7739424,-113.910905,10740,35.1234965,-106.4583918,private,58,36,154,0,36,212,248,47,34,129,0,34,176,210,3.124047261
16980,41.8235214,-87.8282967,20900,29.2784805,-96.2296745,private,160,0,341,0,0,501,501,165,0,367,0,0,532,532,3.324766951
38060,33.1857653,-112.0678624,31860,44.1548096,-94.1478013,private,91,129,85,0,129,176,305,93,121,88,0,121,181,302,3.181395744
31080,34.1087033,-118.1827533,46520,21.5800225,-158.1234063,private,23,0,274,0,0,297,297,38,0,355,0,0,393,393,3.238120874
26420,29.7495926,-95.3536422,45300,28.1259071,-82.4652858,private,77,0,395,0,0,472,472,80,0,355,0,0,435,435,3.264301703
26420,29.7495926,-95.3536422,23620,33.6391964,-97.2103433,private,79,0,195,0,0,274,274,85,0,219,0,0,304,304,3.18264245
31080,34.1087033,-118.1827533,41620,40.5728869,-112.9532527,private,28,0,321,0,0,349,349,68,0,467,0,0,535,535,3.32663701
47900,38.7982054,-77.4868816,16740,35.1663423,-80.7972848,private,23,0,206,0,0,229,229,31,0,242,0,0,273,273,3.163318505
16980,41.8235214,-87.8282967,39580,35.7567464,-78.4604412,private,223,0,471,0,0,694,694,190,13,519,0,13,709,722,3.443204035
20900,29.2784805,-96.2296745,28660,31.2027301,-97.7896384,private,59,0,120,0,0,179,179,62,0,121,0,0,183,183,3.107216729
49740,32.7739424,-113.910905,49420,46.4565581,-120.7401446,private,38,111,33,0,111,71,182,35,85,40,0,85,75,160,3.092879608
16980,41.8235214,-87.8282967,39540,42.7541215,-87.4208775,private,69,0,242,0,0,311,311,54,0,262,0,0,316,316,3.190122687
38060,33.1857653,-112.0678624,34740,43.2892579,-86.751892,private,64,134,98,0,134,162,296,97,101,95,0,101,192,293,3.175785567
49740,32.7739424,-113.910905,32780,42.4116214,-122.6756106,private,54,63,64,0,63,118,181,61,48,65,0,48,126,174,3.101606551
38060,33.1857653,-112.0678624,28060,48.3146779,-114.0542951,private,49,133,73,0,133,122,255,69,144,119,0,144,188,332,3.200096336
37980,39.8949576,-75.3119824,47220,39.3284336,-75.1216277,private,46,0,181,0,0,227,227,49,0,202,0,0,251,251,3.149604737
14460,42.517606,-71.0219925,36740,28.4343962,-81.3560839,private,73,11,307,31,42,380,422,73,12,320,0,12,393,405,3.245601111
14460,42.517606,-71.0219925,38300,40.4395249,-79.8360972,private,16,0,173,0,0,189,189,19,0,196,0,0,215,215,3.127164027
35620,40.77493,-73.873758,35380,29.805532,-89.7013821,private,23,0,221,0,0,244,244,29,16,398,0,16,427,443,3.269288527
35620,40.77493,-73.873758,40140,34.5384763,-116.1345414,private,19,15,307,0,15,326,341,33,35,391,0,35,424,459,3.279262177
47900,38.7982054,-77.4868816,38300,40.4395249,-79.8360972,private,14,0,142,0,0,156,156,19,0,223,0,0,242,242,3.14399456
19100,32.8491708,-96.9704894,22660,40.6580933,-105.4867638,private,73,30,131,0,30,204,234,80,15,141,0,15,221,236,3.140254441
19100,32.8491708,-96.9704894,41740,33.0236041,-116.7761174,private,97,0,502,0,0,599,599,95,0,426,0,0,521,521,3.317910067
49740,32.7739424,-113.910905,25840,45.5446021,-119.0761905,private,46,80,52,0,80,98,178,49,60,35,0,60,84,144,3.082905959
42660,47.4905993,-121.833996,47900,38.7982054,-77.4868816,private,172,0,873,0,0,1045,1045,160,0,939,0,0,1099,1099,3.678208143
19100,32.8491708,-96.9704894,43340,32.4376822,-93.7448836,private,95,0,251,0,0,346,346,108,0,267,0,0,375,375,3.226900519
37980,39.8949576,-75.3119824,19740,39.434789,-104.9010728,private,27,0,322,0,0,349,349,25,0,301,0,0,326,326,3.196356218
33460,45.096664,-93.275361,33340,43.0176601,-87.4815541,private,98,0,386,0,0,484,484,90,0,438,0,0,528,528,3.322273539
42660,47.4905993,-121.833996,40700,43.2863277,-123.154476,private,78,0,329,0,0,407,407,54,16,309,0,16,363,379,3.229393931
35620,40.77493,-73.873758,20900,29.2784805,-96.2296745,private,75,0,212,0,0,287,287,107,0,457,0,0,564,564,3.344714249
31080,34.1087033,-118.1827533,41500,36.240107,-121.3155723,private,17,0,244,0,0,261,261,39,13,364,0,13,403,416,3.252457995
42660,47.4905993,-121.833996,41700,29.4330599,-98.6069734,private,141,0,255,0,0,396,396,176,0,372,0,0,548,548,3.3347406
16980,41.8235214,-87.8282967,12580,39.304361,-76.5495009,private,44,0,308,0,0,352,352,36,0,355,0,0,391,391,3.236874168
49740,32.7739424,-113.910905,31540,43.0842941,-89.5971796,private,64,168,77,0,168,141,309,70,115,80,0,115,150,265,3.158331681
47900,38.7982054,-77.4868816,16700,33.0180695,-80.0075006,private,15,0,84,0,0,99,99,28,15,131,0,15,159,174,3.101606551
42660,47.4905993,-121.833996,12060,33.693728,-84.3999113,private,174,0,577,0,0,751,751,153,0,666,0,0,819,819,3.503669283
35620,40.77493,-73.873758,29460,27.9536488,-81.6935337,private,61,0,335,0,0,396,396,139,0,439,0,0,578,578,3.353441192
38060,33.1857653,-112.0678624,22020,46.9148591,-96.9601826,private,138,189,117,0,189,255,444,163,161,121,0,161,284,445,3.270535234
16980,41.8235214,-87.8282967,32820,35.0244194,-89.8719712,private,79,0,331,0,0,410,410,60,0,356,0,0,416,416,3.252457995
33460,45.096664,-93.275361,38900,45.6006221,-122.484378,private,42,0,395,0,0,437,437,45,0,384,0,0,429,429,3.260561584
37980,39.8949576,-75.3119824,36740,28.4343962,-81.3560839,private,118,0,459,0,0,577,577,133,23,457,0,23,590,613,3.37525855
16980,41.8235214,-87.8282967,16700,33.0180695,-80.0075006,private,84,11,228,0,11,312,323,128,47,252,0,47,380,427,3.259314878
38060,33.1857653,-112.0678624,33540,47.0272632,-113.8926911,private,62,117,92,0,117,154,271,88,121,122,0,121,210,331,3.199472983
14460,42.517606,-71.0219925,33460,45.096664,-93.275361,private,49,0,226,11,11,275,286,16,0,301,0,0,317,317,3.19074604
16980,41.8235214,-87.8282967,29460,27.9536488,-81.6935337,private,128,162,248,0,162,376,538,124,157,254,0,157,378,535,3.32663701
12060,33.693728,-84.3999113,20900,29.2784805,-96.2296745,private,111,0,210,0,0,321,321,126,0,226,0,0,352,352,3.212563398
38060,33.1857653,-112.0678624,40900,38.7896779,-121.0057504,private,96,20,385,0,20,481,501,116,27,396,0,27,512,539,3.329130422
49740,32.7739424,-113.910905,19820,42.7218478,-83.2008463,private,94,201,159,0,201,253,454,82,142,174,0,142,256,398,3.241237639
37980,39.8949576,-75.3119824,29460,27.9536488,-81.6935337,private,56,14,102,0,14,158,172,37,14,184,0,14,221,235,3.139631088
33460,45.096664,-93.275361,31540,43.0842941,-89.5971796,private,38,0,424,0,0,462,462,74,0,440,0,0,514,514,3.313546596
19100,32.8491708,-96.9704894,39580,35.7567464,-78.4604412,private,102,0,240,0,0,342,342,91,0,213,0,0,304,304,3.18264245
41860,37.7737185,-122.2744317,41620,40.5728869,-112.9532527,private,11,0,107,0,0,118,118,52,0,208,0,0,260,260,3.155214915
47900,38.7982054,-77.4868816,20500,36.0605886,-78.9897875,private,11,0,137,0,0,148,148,13,0,154,0,0,167,167,3.097243079
19100,32.8491708,-96.9704894,33100,26.1018281,-80.4787552,private,232,12,746,0,12,978,990,180,12,704,0,12,884,896,3.551667469
41860,37.7737185,-122.2744317,14500,40.0949699,-105.3976911,private,34,0,112,0,0,146,146,45,0,196,0,0,241,241,3.143371207
43220,47.3541257,-123.1738498,10540,44.4888982,-122.5372084,private,37,0,117,0,0,154,154,50,15,100,0,15,150,165,3.095996373
33100,26.1018281,-80.4787552,11460,42.2522168,-83.8434233,private,39,58,97,0,58,136,194,36,46,111,0,46,147,193,3.113450259
42660,47.4905993,-121.833996,46520,21.5800225,-158.1234063,private,60,44,248,0,44,308,352,66,48,218,0,48,284,332,3.200096336
16980,41.8235214,-87.8282967,29200,40.4821533,-87.0171117,private,52,0,306,0,0,358,358,90,0,311,0,0,401,401,3.243107698
33100,26.1018281,-80.4787552,42660,47.4905993,-121.833996,private,71,0,410,0,0,481,481,44,0,302,0,0,346,346,3.208823279
37980,39.8949576,-75.3119824,16740,35.1663423,-80.7972848,private,73,0,306,0,0,379,379,71,0,302,0,0,373,373,3.225653812
38060,33.1857653,-112.0678624,19780,41.5770501,-93.7597124,private,202,291,289,0,291,491,782,250,246,305,0,246,555,801,3.492448928
33100,26.1018281,-80.4787552,35300,41.3497185,-72.9002033,private,54,76,118,0,76,172,248,42,84,107,0,84,149,233,3.138384382
35620,40.77493,-73.873758,41620,40.5728869,-112.9532527,private,14,0,126,0,0,140,140,36,21,226,0,21,262,283,3.169552036
31080,34.1087033,-118.1827533,17020,39.6659588,-121.6019188,private,33,0,274,0,0,307,307,49,0,400,0,0,449,449,3.273028646
12060,33.693728,-84.3999113,32820,35.0244194,-89.8719712,private,151,0,415,0,0,566,566,90,0,408,0,0,498,498,3.303572946
38060,33.1857653,-112.0678624,28020,42.2462657,-85.5328544,private,53,130,94,0,130,147,277,50,107,73,0,107,123,230,3.136514323
42660,47.4905993,-121.833996,28660,31.2027301,-97.7896384,private,64,0,130,0,0,194,194,75,0,119,0,0,194,194,3.114073612
12060,33.693728,-84.3999113,36380,27.3855924,-80.8873884,private,92,11,206,0,11,298,309,107,17,208,0,17,315,332,3.200096336
34580,48.4932917,-121.8157703,40700,43.2863277,-123.154476,private,37,0,122,0,0,159,159,31,0,120,0,0,151,151,3.08726943
12060,33.693728,-84.3999113,45220,30.3864255,-84.2804096,private,99,0,259,0,0,358,358,111,0,291,0,0,402,402,3.243731051
19100,32.8491708,-96.9704894,45300,28.1259071,-82.4652858,private,176,0,573,0,0,749,749,153,0,566,0,0,719,719,3.441333976
31080,34.1087033,-118.1827533,20900,29.2784805,-96.2296745,private,89,0,296,0,0,385,385,137,0,437,0,0,574,574,3.35094778
41860,37.7737185,-122.2744317,31460,37.2098213,-119.7498023,private,29,0,115,0,0,144,144,50,0,227,0,0,277,277,3.165811917
12060,33.693728,-84.3999113,37980,39.8949576,-75.3119824,private,133,0,791,0,0,924,924,83,0,783,0,0,866,866,3.532966877
19100,32.8491708,-96.9704894,37860,30.6554013,-87.1618275,private,65,0,164,0,0,229,229,72,12,190,0,12,262,274,3.163941858
49740,32.7739424,-113.910905,28020,42.2462657,-85.5328544,private,37,69,52,0,69,89,158,33,66,53,0,66,86,152,3.087892783
14460,42.517606,-71.0219925,30100,43.7857256,-72.1591415,private,13,0,115,13,13,128,141,48,100,220,0,100,268,368,3.222537047
38060,33.1857653,-112.0678624,21340,31.527394,-105.5213326,private,95,0,202,0,0,297,297,93,0,254,0,0,347,347,3.209446632
47900,38.7982054,-77.4868816,38900,45.6006221,-122.484378,private,13,0,180,0,0,193,193,0,0,179,0,0,179,179,3.104723316
43220,47.3541257,-123.1738498,40700,43.2863277,-123.154476,private,37,0,120,0,0,157,157,38,0,97,0,0,135,135,3.077295781
14460,42.517606,-71.0219925,12740,44.2749884,-72.6095138,private,15,0,49,0,0,64,64,22,53,82,0,53,104,157,3.091009549
47900,38.7982054,-77.4868816,19100,32.8491708,-96.9704894,private,27,0,212,0,0,239,239,26,0,314,0,0,340,340,3.205083161
16980,41.8235214,-87.8282967,22660,40.6580933,-105.4867638,private,109,0,277,0,0,386,386,112,0,319,0,0,431,431,3.261808291
19100,32.8491708,-96.9704894,11100,35.2478969,-101.9086384,private,53,0,244,0,0,297,297,103,0,291,0,0,394,394,3.238744227
31080,34.1087033,-118.1827533,33460,45.096664,-93.275361,private,36,0,549,0,0,585,585,27,0,548,0,0,575,575,3.351571133
33460,45.096664,-93.275361,14460,42.517606,-71.0219925,private,18,0,288,0,0,306,306,11,0,196,0,0,207,207,3.122177202
33460,45.096664,-93.275361,31080,34.1087033,-118.1827533,private,59,19,677,0,19,736,755,56,29,566,0,29,622,651,3.398945967
41860,37.7737185,-122.2744317,33460,45.096664,-93.275361,private,12,0,215,0,0,227,227,33,0,383,0,0,416,416,3.252457995
14460,42.517606,-71.0219925,20500,36.0605886,-78.9897875,private,14,0,141,0,0,155,155,20,0,144,0,0,164,164,3.09537302
14460,42.517606,-71.0219925,37340,28.2983112,-80.7003334,private,18,28,66,43,71,84,155,21,32,97,0,32,118,150,3.086646077
14460,42.517606,-71.0219925,34980,36.1181822,-86.6441196,private,19,0,189,0,0,208,208,12,0,136,0,0,148,148,3.085399371
49740,32.7739424,-113.910905,20260,47.3475056,-92.1553326,private,41,119,43,0,119,84,203,45,87,26,0,87,71,158,3.091632902
49740,32.7739424,-113.910905,41700,29.4330599,-98.6069734,private,82,0,146,0,0,228,228,64,0,148,0,0,212,212,3.125293968
41860,37.7737185,-122.2744317,14860,41.2274128,-73.3670614,private,28,0,84,0,0,112,112,47,0,171,0,0,218,218,3.129034086
33100,26.1018281,-80.4787552,41980,18.2944526,-66.0368437,private,42,0,264,0,0,306,306,40,0,258,0,0,298,298,3.178902332
33460,45.096664,-93.275361,12060,33.693728,-84.3999113,private,134,0,534,0,0,668,668,93,0,478,0,0,571,571,3.349077721
16980,41.8235214,-87.8282967,41940,36.9084718,-121.3713721,private,78,0,519,0,0,597,597,43,0,417,0,0,460,460,3.27988553
38060,33.1857653,-112.0678624,44060,48.091618,-117.663472,private,106,145,262,0,145,368,513,118,153,284,0,153,402,555,3.339104072
42660,47.4905993,-121.833996,22180,35.1559863,-78.93185,private,71,0,124,0,0,195,195,62,0,90,0,0,152,152,3.087892783
35620,40.77493,-73.873758,18140,39.9685617,-82.8359105,private,47,0,313,0,0,360,360,89,11,638,0,11,727,738,3.453177684
35620,40.77493,-73.873758,39740,40.4139565,-75.9268598,private,48,0,253,0,0,301,301,68,0,400,0,0,468,468,3.284872354
34580,48.4932917,-121.8157703,33540,47.0272632,-113.8926911,private,32,0,72,0,0,104,104,38,11,104,0,11,142,153,3.088516136
37980,39.8949576,-75.3119824,41860,37.7737185,-122.2744317,private,23,0,546,0,0,569,569,11,0,426,0,0,437,437,3.265548409
35620,40.77493,-73.873758,37260,29.5938964,-81.7320389,private,68,24,234,0,24,302,326,106,80,346,0,80,452,532,3.324766951
20900,29.2784805,-96.2296745,12060,33.693728,-84.3999113,private,108,0,181,0,0,289,289,85,0,167,0,0,252,252,3.150228091
34580,48.4932917,-121.8157703,29420,35.717705,-113.7496891,private,34,55,62,0,55,96,151,31,51,51,0,51,82,133,3.076049075
35620,40.77493,-73.873758,48900,34.4260331,-77.889634,private,32,0,119,0,0,151,151,32,23,280,0,23,312,335,3.201966396
12060,33.693728,-84.3999113,22180,35.1559863,-78.93185,private,111,0,255,0,0,366,366,101,0,284,0,0,385,385,3.233134049
33100,26.1018281,-80.4787552,19820,42.7218478,-83.2008463,private,97,141,244,0,141,341,482,82,98,258,0,98,340,438,3.266171762
49740,32.7739424,-113.910905,34740,43.2892579,-86.751892,private,37,76,37,0,76,74,150,40,71,35,0,71,75,146,3.084152665
35620,40.77493,-73.873758,25940,32.3867916,-80.8308775,private,0,0,77,0,0,77,77,25,40,166,0,40,191,231,3.137137676
33460,45.096664,-93.275361,45300,28.1259071,-82.4652858,private,186,268,469,0,268,655,923,154,291,456,0,291,610,901,3.554784235
16980,41.8235214,-87.8282967,37340,28.2983112,-80.7003334,private,103,144,202,0,144,305,449,110,166,232,0,166,342,508,3.309806477
16980,41.8235214,-87.8282967,19340,41.3916799,-90.460076,private,37,0,456,0,0,493,493,68,0,528,0,0,596,596,3.364661548
31080,34.1087033,-118.1827533,21580,36.5096687,-106.6939829,private,14,0,114,0,0,128,128,15,0,231,0,0,246,246,3.146487972
41860,37.7737185,-122.2744317,23420,36.7610058,-119.6550193,private,23,0,151,0,0,174,174,40,0,224,0,0,264,264,3.157708327
43220,47.3541257,-123.1738498,41700,29.4330599,-98.6069734,private,64,0,113,0,0,177,177,86,0,120,0,0,206,206,3.121553849
42660,47.4905993,-121.833996,37980,39.8949576,-75.3119824,private,16,0,343,0,0,359,359,11,0,350,0,0,361,361,3.218173575
19100,32.8491708,-96.9704894,35840,27.3642461,-82.3193579,private,44,14,112,0,14,156,170,79,12,147,0,12,226,238,3.141501148
42660,47.4905993,-121.833996,40900,38.7896779,-121.0057504,private,104,0,475,0,0,579,579,113,0,499,0,0,612,612,3.374635197
14460,42.517606,-71.0219925,41940,36.9084718,-121.3713721,private,53,0,326,30,30,379,409,25,0,341,0,0,366,366,3.221290341
35620,40.77493,-73.873758,47260,36.8044077,-76.4495261,private,24,0,473,0,0,497,497,58,27,693,0,27,751,778,3.478111807
37980,39.8949576,-75.3119824,45300,28.1259071,-82.4652858,private,115,93,476,0,93,591,684,158,83,634,0,83,792,875,3.538577055
31080,34.1087033,-118.1827533,34580,48.4932917,-121.8157703,private,90,0,389,0,0,479,479,92,30,466,0,30,558,588,3.359674723
38060,33.1857653,-112.0678624,28140,38.9318494,-94.4438241,private,111,87,282,0,87,393,480,129,86,279,0,86,408,494,3.301079534
31080,34.1087033,-118.1827533,39150,34.631071,-112.5772247,private,169,0,386,0,0,555,555,204,0,411,0,0,615,615,3.376505256
12060,33.693728,-84.3999113,34940,26.118786,-81.4009553,private,81,79,130,0,79,211,290,90,96,161,0,96,251,347,3.209446632
12060,33.693728,-84.3999113,36100,29.2028047,-82.0431004,private,109,0,209,0,0,318,318,102,11,252,0,11,354,365,3.220666988
12060,33.693728,-84.3999113,26900,39.74867,-86.2123823,private,113,0,405,0,0,518,518,90,0,383,0,0,473,473,3.28798912
26420,29.7495926,-95.3536422,25720,40.6913977,-111.0527658,private,60,13,98,0,13,158,171,64,40,100,0,40,164,204,3.120307143
42660,47.4905993,-121.833996,33540,47.0272632,-113.8926911,private,68,0,164,0,0,232,232,87,14,202,0,14,289,303,3.182019097
12060,33.693728,-84.3999113,12580,39.304361,-76.5495009,private,94,0,562,0,0,656,656,61,0,556,0,0,617,617,3.377751962
26420,29.7495926,-95.3536422,36420,35.4309676,-97.5069659,private,96,0,205,0,0,301,301,90,0,245,0,0,335,335,3.201966396
38060,33.1857653,-112.0678624,17460,41.7603919,-81.7242168,private,64,95,225,0,95,289,384,80,59,242,0,59,322,381,3.230640637
49740,32.7739424,-113.910905,41620,40.5728869,-112.9532527,private,33,31,81,0,31,114,145,23,24,50,0,24,73,97,3.053608364
43220,47.3541257,-123.1738498,29420,35.717705,-113.7496891,private,38,59,48,0,59,86,145,32,64,49,0,64,81,145,3.083529312
12060,33.693728,-84.3999113,17900,34.0775845,-81.0378453,private,163,0,512,0,0,675,675,173,0,579,0,0,752,752,3.461904627
33460,45.096664,-93.275361,22020,46.9148591,-96.9601826,private,39,0,314,0,0,353,353,80,0,347,0,0,427,427,3.259314878
33100,26.1018281,-80.4787552,24860,34.6837085,-82.4134227,private,75,11,200,0,11,275,286,75,0,177,0,0,252,252,3.150228091
47900,38.7982054,-77.4868816,34980,36.1181822,-86.6441196,private,12,0,153,0,0,165,165,21,0,160,0,0,181,181,3.105970022
31080,34.1087033,-118.1827533,16740,35.1663423,-80.7972848,private,60,0,342,0,0,402,402,28,0,388,0,0,416,416,3.252457995
42660,47.4905993,-121.833996,28060,48.3146779,-114.0542951,private,48,0,98,0,0,146,146,72,29,128,0,29,200,229,3.13589097
12060,33.693728,-84.3999113,19820,42.7218478,-83.2008463,private,123,0,618,0,0,741,741,89,0,595,0,0,684,684,3.419516618
16980,41.8235214,-87.8282967,28140,38.9318494,-94.4438241,private,104,0,460,0,0,564,564,96,0,513,0,0,609,609,3.372765138
33100,26.1018281,-80.4787552,41700,29.4330599,-98.6069734,private,78,0,236,0,0,314,314,60,0,247,0,0,307,307,3.18451251
49740,32.7739424,-113.910905,48140,45.0539796,-89.7579047,private,32,76,34,0,76,66,142,36,68,33,0,68,69,137,3.078542487
42660,47.4905993,-121.833996,41620,40.5728869,-112.9532527,private,41,0,207,0,0,248,248,52,0,224,0,0,276,276,3.165188564
14460,42.517606,-71.0219925,38060,33.1857653,-112.0678624,private,33,0,167,18,18,200,218,35,13,202,0,13,237,250,3.148981384
19100,32.8491708,-96.9704894,15980,26.5590348,-81.8919943,private,32,24,100,0,24,132,156,65,40,127,0,40,192,232,3.137761029
31080,34.1087033,-118.1827533,35380,29.805532,-89.7013821,private,14,0,151,0,0,165,165,12,0,292,0,0,304,304,3.18264245
43220,47.3541257,-123.1738498,16700,33.0180695,-80.0075006,private,60,0,62,0,0,122,122,66,0,76,0,0,142,142,3.081659253
20900,29.2784805,-96.2296745,13140,30.0759278,-94.2027049,private,72,0,137,0,0,209,209,69,0,139,0,0,208,208,3.122800555
31080,34.1087033,-118.1827533,31460,37.2098213,-119.7498023,private,102,0,313,0,0,415,415,139,0,448,0,0,587,587,3.35905137
34580,48.4932917,-121.8157703,31080,34.1087033,-118.1827533,private,71,50,304,0,50,375,425,46,62,301,0,62,347,409,3.248094523
12060,33.693728,-84.3999113,46660,30.8271579,-83.2435547,private,94,0,270,0,0,364,364,86,0,278,0,0,364,364,3.220043635
12060,33.693728,-84.3999113,33660,30.9715095,-88.20787,private,173,0,351,0,0,524,524,173,17,371,0,17,544,561,3.34284419
31080,34.1087033,-118.1827533,43220,47.3541257,-123.1738498,private,89,0,385,0,0,474,474,112,11,461,0,11,573,584,3.357181311
34580,48.4932917,-121.8157703,19100,32.8491708,-96.9704894,private,93,0,147,0,0,240,240,121,0,221,0,0,342,342,3.206329867
16980,41.8235214,-87.8282967,41620,40.5728869,-112.9532527,private,34,0,152,0,0,186,186,35,0,159,0,0,194,194,3.114073612
19100,32.8491708,-96.9704894,45500,33.4783701,-94.2071694,private,80,0,191,0,0,271,271,84,0,196,0,0,280,280,3.167681977
26420,29.7495926,-95.3536422,47900,38.7982054,-77.4868816,private,161,0,697,0,0,858,858,87,0,610,0,0,697,697,3.427620208
26420,29.7495926,-95.3536422,16740,35.1663423,-80.7972848,private,40,0,171,0,0,211,211,34,0,180,0,0,214,214,3.126540674
49740,32.7739424,-113.910905,40340,43.9496362,-92.3360701,private,32,78,29,0,78,61,139,37,62,38,0,62,75,137,3.078542487
49740,32.7739424,-113.910905,33700,37.5623162,-121.0028311,private,39,34,66,0,34,105,139,29,31,67,0,31,96,127,3.072308956
16980,41.8235214,-87.8282967,27260,30.2365943,-81.7544462,private,237,39,463,0,39,700,739,260,53,471,0,53,731,784,3.481851925
26420,29.7495926,-95.3536422,49740,32.7739424,-113.910905,private,42,0,87,0,0,129,129,51,0,157,0,0,208,208,3.122800555
26420,29.7495926,-95.3536422,38900,45.6006221,-122.484378,private,27,0,183,0,0,210,210,45,0,202,0,0,247,247,3.147111325
31080,34.1087033,-118.1827533,10740,35.1234965,-106.4583918,private,52,0,305,0,0,357,357,59,0,403,0,0,462,462,3.281132236
33460,45.096664,-93.275361,29460,27.9536488,-81.6935337,private,49,109,74,0,109,123,232,28,102,57,0,102,85,187,3.109710141
16980,41.8235214,-87.8282967,23060,41.1131166,-85.2177047,private,53,0,282,0,0,335,335,56,0,278,0,0,334,334,3.201343043
19100,32.8491708,-96.9704894,41180,38.7402108,-90.3458253,private,83,0,402,0,0,485,485,100,0,365,0,0,465,465,3.283002295
35620,40.77493,-73.873758,45060,43.0065163,-76.1961336,private,0,0,317,0,0,317,317,30,69,732,0,69,762,831,3.51114952
19100,32.8491708,-96.9704894,36740,28.4343962,-81.3560839,private,116,0,409,0,0,525,525,116,0,433,0,0,549,549,3.335363953
37980,39.8949576,-75.3119824,37260,29.5938964,-81.7320389,private,45,51,113,0,51,158,209,36,44,102,0,44,138,182,3.106593375
33460,45.096664,-93.275361,35620,40.77493,-73.873758,private,14,0,454,0,0,468,468,0,0,396,0,0,396,396,3.239990933
49740,32.7739424,-113.910905,31860,44.1548096,-94.1478013,private,39,68,30,0,68,69,137,40,54,24,0,54,64,118,3.066698779
37980,39.8949576,-75.3119824,39580,35.7567464,-78.4604412,private,46,0,211,0,0,257,257,64,0,300,0,0,364,364,3.220043635
47900,38.7982054,-77.4868816,33460,45.096664,-93.275361,private,15,0,152,0,0,167,167,16,0,201,0,0,217,217,3.128410733
12060,33.693728,-84.3999113,31140,38.3058381,-85.6816455,private,65,0,234,0,0,299,299,55,0,260,0,0,315,315,3.189499334
33100,26.1018281,-80.4787552,35900,36.2088833,-81.1660949,private,25,131,65,0,131,90,221,37,130,88,0,130,125,255,3.15209815
16980,41.8235214,-87.8282967,24580,44.4740244,-87.9961303,private,51,78,228,0,78,279,357,120,158,366,0,158,486,644,3.394582495
41860,37.7737185,-122.2744317,34580,48.4932917,-121.8157703,private,17,0,133,0,0,150,150,55,15,189,0,15,244,259,3.154591562
33100,26.1018281,-80.4787552,12700,41.7990145,-70.2118803,private,30,173,43,0,173,73,246,21,153,63,0,153,84,237,3.140877794
35620,40.77493,-73.873758,31660,44.5943758,-74.31067,private,0,0,52,0,0,52,52,15,84,125,0,84,140,224,3.132774205
33100,26.1018281,-80.4787552,34980,36.1181822,-86.6441196,private,117,0,383,0,0,500,500,152,11,408,0,11,560,571,3.349077721
33460,45.096664,-93.275361,41740,33.0236041,-116.7761174,private,57,51,342,0,51,399,450,64,45,275,0,45,339,384,3.232510696
26420,29.7495926,-95.3536422,27260,30.2365943,-81.7544462,private,43,0,144,0,0,187,187,71,0,186,0,0,257,257,3.153344856
20900,29.2784805,-96.2296745,28780,27.1139432,-97.5685077,private,49,0,80,0,0,129,129,53,0,83,0,0,136,136,3.077919134
41860,37.7737185,-122.2744317,46060,32.1280427,-111.7836574,private,30,0,123,0,0,153,153,39,23,183,0,23,222,245,3.145864619
43220,47.3541257,-123.1738498,25720,40.6913977,-111.0527658,private,56,0,68,0,0,124,124,59,13,64,0,13,123,136,3.077919134
37980,39.8949576,-75.3119824,27260,30.2365943,-81.7544462,private,89,0,216,0,0,305,305,72,14,238,0,14,310,324,3.195109512
19100,32.8491708,-96.9704894,14460,42.517606,-71.0219925,private,71,0,353,0,0,424,424,11,0,287,0,0,298,298,3.178902332
43220,47.3541257,-123.1738498,47260,36.8044077,-76.4495261,private,149,0,159,0,0,308,308,47,0,153,0,0,200,200,3.117813731
37980,39.8949576,-75.3119824,41740,33.0236041,-116.7761174,private,38,13,197,0,13,235,248,45,0,233,0,0,278,278,3.16643527
38060,33.1857653,-112.0678624,33500,48.3202424,-101.1980099,private,54,121,39,0,121,93,214,59,124,49,0,124,108,232,3.137761029
12060,33.693728,-84.3999113,11460,42.2522168,-83.8434233,private,73,0,258,0,0,331,331,76,0,239,0,0,315,315,3.189499334
19100,32.8491708,-96.9704894,27260,30.2365943,-81.7544462,private,104,0,251,0,0,355,355,65,0,232,0,0,297,297,3.178278979
37980,39.8949576,-75.3119824,37340,28.2983112,-80.7003334,private,40,40,91,0,40,131,171,30,68,95,0,68,125,193,3.113450259
31080,34.1087033,-118.1827533,17660,47.6759658,-116.6959222,private,67,0,144,0,0,211,211,126,0,235,0,0,361,361,3.218173575
12060,33.693728,-84.3999113,41740,33.0236041,-116.7761174,private,133,0,415,0,0,548,548,62,0,367,0,0,429,429,3.260561584
26420,29.7495926,-95.3536422,34980,36.1181822,-86.6441196,private,97,0,273,0,0,370,370,93,0,221,0,0,314,314,3.188875981
35620,40.77493,-73.873758,46520,21.5800225,-158.1234063,private,0,12,119,0,12,119,131,12,26,212,0,26,224,250,3.148981384
47900,38.7982054,-77.4868816,14860,41.2274128,-73.3670614,private,0,0,69,0,0,69,69,13,11,134,0,11,147,158,3.091632902
38060,33.1857653,-112.0678624,34980,36.1181822,-86.6441196,private,115,0,325,0,0,440,440,153,0,381,0,0,534,534,3.326013657
34580,48.4932917,-121.8157703,25720,40.6913977,-111.0527658,private,43,0,66,0,0,109,109,50,0,83,0,0,133,133,3.076049075
38060,33.1857653,-112.0678624,20260,47.3475056,-92.1553326,private,66,186,80,0,186,146,332,73,138,76,0,138,149,287,3.172045448
14460,42.517606,-71.0219925,16700,33.0180695,-80.0075006,private,15,0,102,0,0,117,117,26,0,106,0,0,132,132,3.075425722
16980,41.8235214,-87.8282967,43780,41.7749808,-86.1230143,private,17,0,154,0,0,171,171,33,0,156,0,0,189,189,3.110956847
38060,33.1857653,-112.0678624,40300,42.041884,-89.3201764,private,46,69,78,0,69,124,193,51,60,91,0,60,142,202,3.119060437
49740,32.7739424,-113.910905,13940,43.2163568,-112.3992058,private,33,58,40,0,58,73,131,32,48,27,0,48,59,107,3.059841895
42660,47.4905993,-121.833996,34980,36.1181822,-86.6441196,private,103,0,326,0,0,429,429,139,0,334,0,0,473,473,3.28798912
34580,48.4932917,-121.8157703,27260,30.2365943,-81.7544462,private,89,0,104,0,0,193,193,78,0,124,0,0,202,202,3.119060437
12060,33.693728,-84.3999113,28940,36.0147907,-84.2067014,private,173,0,476,0,0,649,649,178,0,515,0,0,693,693,3.425126796
47900,38.7982054,-77.4868816,17460,41.7603919,-81.7242168,private,0,0,103,0,0,103,103,12,0,144,0,0,156,156,3.090386196
33460,45.096664,-93.275361,33100,26.1018281,-80.4787552,private,102,183,361,0,183,463,646,68,222,307,0,222,375,597,3.365284901
16980,41.8235214,-87.8282967,16060,37.6897419,-89.1051489,private,59,0,297,0,0,356,356,83,0,335,0,0,418,418,3.253704701
26420,29.7495926,-95.3536422,47380,31.4272264,-97.0934727,private,109,0,207,0,0,316,316,101,0,262,0,0,363,363,3.219420282
49740,32.7739424,-113.910905,25740,46.8113536,-112.2840307,private,24,75,30,0,75,54,129,42,65,22,0,65,64,129,3.073555663
47900,38.7982054,-77.4868816,47260,36.8044077,-76.4495261,private,41,0,148,0,0,189,189,30,12,191,0,12,221,233,3.138384382
26420,29.7495926,-95.3536422,41180,38.7402108,-90.3458253,private,27,0,211,0,0,238,238,29,0,202,0,0,231,231,3.137137676
47900,38.7982054,-77.4868816,11460,42.2522168,-83.8434233,private,11,0,117,0,0,128,128,0,0,118,0,0,118,118,3.066698779
33100,26.1018281,-80.4787552,17460,41.7603919,-81.7242168,private,64,84,188,0,84,252,336,61,78,173,0,78,234,312,3.187629275
35620,40.77493,-73.873758,14500,40.0949699,-105.3976911,private,25,0,122,0,0,147,147,32,17,209,0,17,241,258,3.153968209
35620,40.77493,-73.873758,22180,35.1559863,-78.93185,private,43,0,215,0,0,258,258,76,12,309,0,12,385,397,3.240614286
47900,38.7982054,-77.4868816,39300,41.7068313,-71.2866369,private,0,0,95,0,0,95,95,17,23,156,0,23,173,196,3.115320318
33460,45.096664,-93.275361,43620,43.4954205,-96.9953387,private,87,0,274,0,0,361,361,132,0,341,0,0,473,473,3.28798912
26420,29.7495926,-95.3536422,32820,35.0244194,-89.8719712,private,23,0,108,0,0,131,131,23,0,160,0,0,183,183,3.107216729
41860,37.7737185,-122.2744317,39820,40.7605142,-122.0435556,private,30,0,115,0,0,145,145,31,0,191,0,0,222,222,3.131527498
43220,47.3541257,-123.1738498,33540,47.0272632,-113.8926911,private,31,0,57,0,0,88,88,58,0,70,0,0,128,128,3.07293231
12060,33.693728,-84.3999113,17460,41.7603919,-81.7242168,private,72,0,326,0,0,398,398,98,0,316,0,0,414,414,3.251211288
26420,29.7495926,-95.3536422,17820,38.8455072,-104.6387277,private,47,0,150,0,0,197,197,40,0,127,0,0,167,167,3.097243079
38060,33.1857653,-112.0678624,16740,35.1663423,-80.7972848,private,118,0,300,0,0,418,418,94,0,306,0,0,400,400,3.242484345
33460,45.096664,-93.275361,47900,38.7982054,-77.4868816,private,46,0,525,0,0,571,571,15,0,450,0,0,465,465,3.283002295
35620,40.77493,-73.873758,36380,27.3855924,-80.8873884,private,90,0,273,0,0,363,363,85,73,356,0,73,441,514,3.313546596
12060,33.693728,-84.3999113,41700,29.4330599,-98.6069734,private,87,0,268,0,0,355,355,82,0,247,0,0,329,329,3.198226277
16980,41.8235214,-87.8282967,35380,29.805532,-89.7013821,private,17,0,164,0,0,181,181,17,0,165,0,0,182,182,3.106593375
31080,34.1087033,-118.1827533,45300,28.1259071,-82.4652858,private,26,0,427,0,0,453,453,45,0,674,0,0,719,719,3.441333976
12060,33.693728,-84.3999113,47260,36.8044077,-76.4495261,private,101,0,501,0,0,602,602,104,0,520,0,0,624,624,3.382115434
12060,33.693728,-84.3999113,17140,39.0998213,-84.4804072,private,83,0,389,0,0,472,472,82,0,330,0,0,412,412,3.249964582
33460,45.096664,-93.275361,26420,29.7495926,-95.3536422,private,56,0,261,0,0,317,317,34,0,257,0,0,291,291,3.17453886
19100,32.8491708,-96.9704894,10740,35.1234965,-106.4583918,private,45,0,206,0,0,251,251,43,0,193,0,0,236,236,3.140254441
26420,29.7495926,-95.3536422,41940,36.9084718,-121.3713721,private,33,0,194,0,0,227,227,13,0,138,0,0,151,151,3.08726943
38060,33.1857653,-112.0678624,47900,38.7982054,-77.4868816,private,74,36,539,0,36,613,649,59,14,487,0,14,546,560,3.342220837
35620,40.77493,-73.873758,46060,32.1280427,-111.7836574,private,12,0,129,0,0,141,141,0,25,225,0,25,225,250,3.148981384
16980,41.8235214,-87.8282967,36540,41.2904587,-95.9999701,private,43,0,191,0,0,234,234,20,0,184,0,0,204,204,3.120307143
26420,29.7495926,-95.3536422,36740,28.4343962,-81.3560839,private,104,0,265,0,0,369,369,57,0,300,0,0,357,357,3.215680163
49740,32.7739424,-113.910905,21340,31.527394,-105.5213326,private,40,0,74,0,0,114,114,37,0,88,0,0,125,125,3.07106225
31080,34.1087033,-118.1827533,40700,43.2863277,-123.154476,private,72,0,363,0,0,435,435,100,11,405,0,11,505,516,3.314793302
19100,32.8491708,-96.9704894,26900,39.74867,-86.2123823,private,83,0,237,0,0,320,320,36,0,178,0,0,214,214,3.126540674
35620,40.77493,-73.873758,21580,36.5096687,-106.6939829,private,13,0,85,0,0,98,98,0,20,171,0,20,171,191,3.112203553
33100,26.1018281,-80.4787552,26900,39.74867,-86.2123823,private,41,24,215,0,24,256,280,51,27,318,0,27,369,396,3.239990933
16980,41.8235214,-87.8282967,25720,40.6913977,-111.0527658,private,92,0,178,0,0,270,270,89,45,175,0,45,264,309,3.185759216
49740,32.7739424,-113.910905,37860,30.6554013,-87.1618275,private,49,25,43,0,25,92,117,50,15,59,0,15,109,124,3.070438897
49740,32.7739424,-113.910905,28140,38.9318494,-94.4438241,private,77,72,83,0,72,160,232,84,56,136,0,56,220,276,3.165188564
38060,33.1857653,-112.0678624,15620,44.3287385,-85.3264287,private,29,110,49,0,110,78,188,35,96,74,0,96,109,205,3.120930496
49740,32.7739424,-113.910905,19700,32.1845231,-107.7471911,private,48,11,64,0,11,112,123,25,18,68,0,18,93,111,3.062335307
49740,32.7739424,-113.910905,39900,40.5007953,-119.7311608,private,30,38,47,0,38,77,115,26,33,64,0,33,90,123,3.069815544
34580,48.4932917,-121.8157703,28060,48.3146779,-114.0542951,private,29,0,57,0,0,86,86,38,19,66,0,19,104,123,3.069815544
16980,41.8235214,-87.8282967,16300,42.0863293,-91.6311439,private,12,0,337,0,0,349,349,18,0,333,0,0,351,351,3.211940045
38060,33.1857653,-112.0678624,33100,26.1018281,-80.4787552,private,91,0,467,0,0,558,558,83,0,451,0,0,534,534,3.326013657
38060,33.1857653,-112.0678624,41180,38.7402108,-90.3458253,private,112,54,341,0,54,453,507,83,36,321,0,36,404,440,3.267418468
35620,40.77493,-73.873758,41700,29.4330599,-98.6069734,private,24,0,228,0,0,252,252,45,0,373,0,0,418,418,3.253704701
37980,39.8949576,-75.3119824,17460,41.7603919,-81.7242168,private,32,0,106,0,0,138,138,15,0,153,0,0,168,168,3.097866432
12060,33.693728,-84.3999113,48900,34.4260331,-77.889634,private,78,0,161,0,0,239,239,99,0,205,0,0,304,304,3.18264245
37980,39.8949576,-75.3119824,44980,40.8515244,-76.709877,private,17,0,90,0,0,107,107,30,0,153,0,0,183,183,3.107216729
47900,38.7982054,-77.4868816,45300,28.1259071,-82.4652858,private,28,0,154,0,0,182,182,18,0,261,0,0,279,279,3.167058624
16980,41.8235214,-87.8282967,20500,36.0605886,-78.9897875,private,12,0,87,0,0,99,99,18,0,138,0,0,156,156,3.090386196
16980,41.8235214,-87.8282967,23660,40.9309446,-90.2137921,private,43,0,170,0,0,213,213,16,0,247,0,0,263,263,3.157084974
49740,32.7739424,-113.910905,12420,30.2395128,-97.6912697,private,61,0,117,0,0,178,178,53,0,135,0,0,188,188,3.110333494
14460,42.517606,-71.0219925,36380,27.3855924,-80.8873884,private,17,22,59,22,44,76,120,13,18,37,0,18,50,68,3.035531125
12060,33.693728,-84.3999113,40060,37.4113241,-77.4418164,private,76,0,458,0,0,534,534,44,0,415,0,0,459,459,3.279262177
33100,26.1018281,-80.4787552,41740,33.0236041,-116.7761174,private,67,0,310,0,0,377,377,66,0,237,0,0,303,303,3.182019097
34580,48.4932917,-121.8157703,41860,37.7737185,-122.2744317,private,45,11,143,0,11,188,199,18,11,124,0,11,142,153,3.088516136
35620,40.77493,-73.873758,13540,43.0353254,-73.1114603,private,0,0,11,0,0,11,11,29,76,97,0,76,126,202,3.119060437
33100,26.1018281,-80.4787552,16700,33.0180695,-80.0075006,private,48,0,118,0,0,166,166,49,0,186,0,0,235,235,3.139631088
16980,41.8235214,-87.8282967,29620,42.7712334,-84.4960294,private,35,0,177,0,0,212,212,51,0,213,0,0,264,264,3.157708327
42660,47.4905993,-121.833996,33100,26.1018281,-80.4787552,private,96,0,477,0,0,573,573,134,21,524,0,21,658,679,3.416399853
38060,33.1857653,-112.0678624,48140,45.0539796,-89.7579047,private,56,88,72,0,88,128,216,55,68,89,0,68,144,212,3.125293968
14460,42.517606,-71.0219925,17460,41.7603919,-81.7242168,private,14,0,107,0,0,121,121,22,0,139,0,0,161,161,3.093502961
16980,41.8235214,-87.8282967,36380,27.3855924,-80.8873884,private,44,90,125,0,90,169,259,60,117,117,0,117,177,294,3.17640892
38060,33.1857653,-112.0678624,21580,36.5096687,-106.6939829,private,18,46,97,0,46,115,161,19,40,118,0,40,137,177,3.10347661
49740,32.7739424,-113.910905,13900,46.887031,-100.979592,private,33,54,14,0,54,47,101,39,60,20,0,60,59,119,3.067322132
34580,48.4932917,-121.8157703,41700,29.4330599,-98.6069734,private,47,0,91,0,0,138,138,72,0,92,0,0,164,164,3.09537302
43220,47.3541257,-123.1738498,40900,38.7896779,-121.0057504,private,55,0,111,0,0,166,166,52,12,128,0,12,180,192,3.112826906
33460,45.096664,-93.275361,29420,35.717705,-113.7496891,private,14,150,36,0,150,50,200,13,128,24,0,128,37,165,3.095996373
33460,45.096664,-93.275361,16740,35.1663423,-80.7972848,private,123,0,222,0,0,345,345,55,0,246,0,0,301,301,3.180772391
42660,47.4905993,-121.833996,11460,42.2522168,-83.8434233,private,44,0,137,0,0,181,181,28,0,147,0,0,175,175,3.102229904
43220,47.3541257,-123.1738498,46520,21.5800225,-158.1234063,private,59,11,47,0,11,106,117,32,13,58,0,13,90,103,3.057348483
33100,26.1018281,-80.4787552,31420,32.8562163,-83.714305,private,44,0,111,0,0,155,155,35,0,200,0,0,235,235,3.139631088
19100,32.8491708,-96.9704894,18580,27.8335972,-97.5089575,private,50,0,136,0,0,186,186,30,0,164,0,0,194,194,3.114073612
20900,29.2784805,-96.2296745,46340,32.3770156,-95.2700409,private,45,0,58,0,0,103,103,58,0,59,0,0,117,117,3.066075426
26420,29.7495926,-95.3536422,37980,39.8949576,-75.3119824,private,46,0,214,0,0,260,260,35,0,239,0,0,274,274,3.163941858
35620,40.77493,-73.873758,41980,18.2944526,-66.0368437,private,0,0,224,0,0,224,224,13,0,344,0,0,357,357,3.215680163
16980,41.8235214,-87.8282967,14500,40.0949699,-105.3976911,private,14,0,96,0,0,110,110,19,0,127,0,0,146,146,3.084152665
26420,29.7495926,-95.3536422,35840,27.3642461,-82.3193579,private,43,0,91,0,0,134,134,49,0,105,0,0,154,154,3.089139489
49740,32.7739424,-113.910905,26420,29.7495926,-95.3536422,private,39,11,105,0,11,144,155,38,0,124,0,0,162,162,3.094126314
34580,48.4932917,-121.8157703,37860,30.6554013,-87.1618275,private,38,0,69,0,0,107,107,35,0,81,0,0,116,116,3.065452073
26420,29.7495926,-95.3536422,31140,38.3058381,-85.6816455,private,28,0,101,0,0,129,129,26,0,109,0,0,135,135,3.077295781
20900,29.2784805,-96.2296745,29180,29.9577733,-92.0493498,private,47,0,68,0,0,115,115,39,0,72,0,0,111,111,3.062335307
41860,37.7737185,-122.2744317,43220,47.3541257,-123.1738498,private,51,0,87,0,0,138,138,41,0,155,0,0,196,196,3.115320318
37980,39.8949576,-75.3119824,38900,45.6006221,-122.484378,private,13,0,139,0,0,152,152,0,0,124,0,0,124,124,3.070438897
38060,33.1857653,-112.0678624,24540,40.555961,-104.383666,private,42,48,110,0,48,152,200,50,42,106,0,42,156,198,3.116567025
42660,47.4905993,-121.833996,17820,38.8455072,-104.6387277,private,75,0,164,0,0,239,239,82,0,185,0,0,267,267,3.159578387
19100,32.8491708,-96.9704894,30020,34.5291104,-98.4309172,private,36,0,131,0,0,167,167,36,0,168,0,0,204,204,3.120307143
19100,32.8491708,-96.9704894,46060,32.1280427,-111.7836574,private,38,0,171,0,0,209,209,49,0,199,0,0,248,248,3.147734678
26420,29.7495926,-95.3536422,46140,36.2544287,-96.1773294,private,67,0,207,0,0,274,274,82,11,193,0,11,275,286,3.171422095
26420,29.7495926,-95.3536422,10740,35.1234965,-106.4583918,private,54,0,84,0,0,138,138,34,0,133,0,0,167,167,3.097243079
38060,33.1857653,-112.0678624,29620,42.7712334,-84.4960294,private,53,63,97,0,63,150,213,60,56,112,0,56,172,228,3.135267617
49740,32.7739424,-113.910905,15620,44.3287385,-85.3264287,private,20,66,20,0,66,40,106,30,55,29,0,55,59,114,3.064205367
41860,37.7737185,-122.2744317,34980,36.1181822,-86.6441196,private,11,0,103,0,0,114,114,40,0,211,0,0,251,251,3.149604737
43220,47.3541257,-123.1738498,31080,34.1087033,-118.1827533,private,38,35,207,0,35,245,280,58,40,231,0,40,289,329,3.198226277
19100,32.8491708,-96.9704894,32820,35.0244194,-89.8719712,private,66,0,224,0,0,290,290,64,0,219,0,0,283,283,3.169552036
38060,33.1857653,-112.0678624,39340,39.872067,-112.3590592,private,49,16,60,0,16,109,125,55,0,96,0,0,151,151,3.08726943
49740,32.7739424,-113.910905,29660,41.6655141,-105.7218826,private,23,49,41,0,49,64,113,24,50,26,0,50,50,100,3.055478423
49740,32.7739424,-113.910905,41500,36.240107,-121.3155723,private,23,45,45,0,45,68,113,14,34,40,0,34,54,88,3.047998187
37980,39.8949576,-75.3119824,48700,41.3438824,-77.0552624,private,22,0,100,0,0,122,122,23,0,133,0,0,156,156,3.090386196
26420,29.7495926,-95.3536422,43340,32.4376822,-93.7448836,private,42,0,90,0,0,132,132,34,0,112,0,0,146,146,3.084152665
20900,29.2784805,-96.2296745,23620,33.6391964,-97.2103433,private,45,0,59,0,0,104,104,46,0,67,0,0,113,113,3.063582013
12060,33.693728,-84.3999113,33860,32.3656313,-86.4045848,private,123,0,341,0,0,464,464,123,0,368,0,0,491,491,3.299209475
38060,33.1857653,-112.0678624,19700,32.1845231,-107.7471911,private,68,0,157,0,0,225,225,60,13,172,0,13,232,245,3.145864619
37980,39.8949576,-75.3119824,16700,33.0180695,-80.0075006,private,14,11,94,0,11,108,119,42,24,140,0,24,182,206,3.121553849
12060,33.693728,-84.3999113,18140,39.9685617,-82.8359105,private,90,0,384,0,0,474,474,107,0,392,0,0,499,499,3.3041963
26420,29.7495926,-95.3536422,31180,33.4703271,-101.6488249,private,12,0,99,0,0,111,111,38,0,136,0,0,174,174,3.101606551
42660,47.4905993,-121.833996,20900,29.2784805,-96.2296745,private,53,0,120,0,0,173,173,49,0,145,0,0,194,194,3.114073612
37980,39.8949576,-75.3119824,12420,30.2395128,-97.6912697,private,27,0,179,0,0,206,206,45,0,168,0,0,213,213,3.125917321
12060,33.693728,-84.3999113,33460,45.096664,-93.275361,private,50,0,403,0,0,453,453,73,0,353,0,0,426,426,3.258691525
12060,33.693728,-84.3999113,20500,36.0605886,-78.9897875,private,44,0,196,0,0,240,240,28,0,176,0,0,204,204,3.120307143
33100,26.1018281,-80.4787552,25540,41.7186503,-72.5739191,private,27,37,122,0,37,149,186,22,50,133,0,50,155,205,3.120930496
38060,33.1857653,-112.0678624,39580,35.7567464,-78.4604412,private,82,0,172,0,0,254,254,70,0,204,0,0,274,274,3.163941858
31080,34.1087033,-118.1827533,11460,42.2522168,-83.8434233,private,22,0,228,0,0,250,250,11,0,274,0,0,285,285,3.170798742
35620,40.77493,-73.873758,24860,34.6837085,-82.4134227,private,27,0,133,0,0,160,160,0,16,242,0,16,242,258,3.153968209
42660,47.4905993,-121.833996,35840,27.3642461,-82.3193579,private,26,23,99,0,23,125,148,64,36,104,0,36,168,204,3.120307143
37980,39.8949576,-75.3119824,38060,33.1857653,-112.0678624,private,32,16,251,0,16,283,299,49,18,260,0,18,309,327,3.196979571
12060,33.693728,-84.3999113,33340,43.0176601,-87.4815541,private,45,0,185,0,0,230,230,23,0,208,0,0,231,231,3.137137676
12060,33.693728,-84.3999113,49740,32.7739424,-113.910905,private,84,0,178,0,0,262,262,57,0,192,0,0,249,249,3.148358031
20900,29.2784805,-96.2296745,41860,37.7737185,-122.2744317,private,35,0,107,0,0,142,142,25,0,51,0,0,76,76,3.04051795
38060,33.1857653,-112.0678624,44020,43.3896107,-95.1960572,private,24,68,30,0,68,54,122,24,66,22,0,66,46,112,3.06295866
14460,42.517606,-71.0219925,29820,36.2142575,-115.013812,private,17,0,64,0,0,81,81,16,0,94,0,0,110,110,3.061711954
37980,39.8949576,-75.3119824,20700,41.0562401,-75.3290651,private,19,0,97,0,0,116,116,42,41,132,0,41,174,215,3.127164027
12060,33.693728,-84.3999113,17820,38.8455072,-104.6387277,private,61,0,161,0,0,222,222,59,0,192,0,0,251,251,3.149604737
12060,33.693728,-84.3999113,35380,29.805532,-89.7013821,private,114,0,467,0,0,581,581,87,0,463,0,0,550,550,3.335987306
26420,29.7495926,-95.3536422,15980,26.5590348,-81.8919943,private,41,0,97,0,0,138,138,23,0,113,0,0,136,136,3.077919134
26420,29.7495926,-95.3536422,26900,39.74867,-86.2123823,private,35,0,127,0,0,162,162,19,0,183,0,0,202,202,3.119060437
38060,33.1857653,-112.0678624,20220,42.4634808,-90.8787708,private,42,38,40,0,38,82,120,46,24,37,0,24,83,107,3.059841895
47900,38.7982054,-77.4868816,41700,29.4330599,-98.6069734,private,15,0,79,0,0,94,94,17,0,103,0,0,120,120,3.067945485
38060,33.1857653,-112.0678624,26900,39.74867,-86.2123823,private,98,79,266,0,79,364,443,99,43,301,0,43,400,443,3.269288527
49740,32.7739424,-113.910905,13740,45.6371402,-108.8323611,private,53,114,35,0,114,88,202,56,103,36,0,103,92,195,3.114696965
49740,32.7739424,-113.910905,24540,40.555961,-104.383666,private,25,41,42,0,41,67,108,25,37,30,0,37,55,92,3.050491599
33100,26.1018281,-80.4787552,14860,41.2274128,-73.3670614,private,35,60,118,0,60,153,213,30,70,138,0,70,168,238,3.141501148
16980,41.8235214,-87.8282967,19780,41.5770501,-93.7597124,private,27,0,338,0,0,365,365,28,0,351,0,0,379,379,3.229393931
19100,32.8491708,-96.9704894,10180,32.4520222,-99.7187428,private,24,0,147,0,0,171,171,36,0,161,0,0,197,197,3.115943672
19100,32.8491708,-96.9704894,34580,48.4932917,-121.8157703,private,15,0,105,0,0,120,120,39,0,91,0,0,130,130,3.074179016
38060,33.1857653,-112.0678624,30700,40.8174581,-96.8687434,private,24,51,49,0,51,73,124,49,47,82,0,47,131,178,3.104099963
49740,32.7739424,-113.910905,12060,33.693728,-84.3999113,private,74,0,181,0,0,255,255,70,0,168,0,0,238,238,3.141501148
43220,47.3541257,-123.1738498,37860,30.6554013,-87.1618275,private,36,12,51,0,12,87,99,46,12,50,0,12,96,108,3.060465248
26420,29.7495926,-95.3536422,39580,35.7567464,-78.4604412,private,44,0,157,0,0,201,201,38,0,123,0,0,161,161,3.093502961
20900,29.2784805,-96.2296745,18580,27.8335972,-97.5089575,private,34,0,73,0,0,107,107,22,0,66,0,0,88,88,3.047998187
38060,33.1857653,-112.0678624,35620,40.77493,-73.873758,private,70,186,636,0,186,706,892,63,81,485,0,81,548,629,3.385232199
49740,32.7739424,-113.910905,19780,41.5770501,-93.7597124,private,84,147,106,0,147,190,337,91,130,75,0,130,166,296,3.177655626
43220,47.3541257,-123.1738498,41860,37.7737185,-122.2744317,private,33,13,116,0,13,149,162,26,0,106,0,0,132,132,3.075425722
26420,29.7495926,-95.3536422,17460,41.7603919,-81.7242168,private,11,0,109,0,0,120,120,28,0,101,0,0,129,129,3.073555663
31080,34.1087033,-118.1827533,39580,35.7567464,-78.4604412,private,61,0,310,0,0,371,371,92,0,351,0,0,443,443,3.269288527
31080,34.1087033,-118.1827533,17460,41.7603919,-81.7242168,private,30,0,186,0,0,216,216,11,0,307,0,0,318,318,3.191369393
41860,37.7737185,-122.2744317,38300,40.4395249,-79.8360972,private,13,0,102,0,0,115,115,13,0,143,0,0,156,156,3.090386196
43220,47.3541257,-123.1738498,27260,30.2365943,-81.7544462,private,64,0,100,0,0,164,164,58,0,78,0,0,136,136,3.077919134
12060,33.693728,-84.3999113,38900,45.6006221,-122.484378,private,12,0,278,0,0,290,290,52,0,279,0,0,331,331,3.199472983
38060,33.1857653,-112.0678624,18140,39.9685617,-82.8359105,private,37,51,217,0,51,254,305,60,35,200,0,35,260,295,3.177032273
31080,34.1087033,-118.1827533,10540,44.4888982,-122.5372084,private,55,0,286,0,0,341,341,70,0,311,0,0,381,381,3.230640637
49740,32.7739424,-113.910905,36420,35.4309676,-97.5069659,private,53,16,84,0,16,137,153,51,0,86,0,0,137,137,3.078542487
14460,42.517606,-71.0219925,41180,38.7402108,-90.3458253,private,0,0,94,0,0,94,94,12,0,121,0,0,133,133,3.076049075
35620,40.77493,-73.873758,25420,40.335915,-77.0504897,private,12,0,284,0,0,296,296,41,14,485,0,14,526,540,3.329753776
35620,40.77493,-73.873758,12740,44.2749884,-72.6095138,private,0,0,35,0,0,35,35,12,56,124,0,56,136,192,3.112826906
37980,39.8949576,-75.3119824,19100,32.8491708,-96.9704894,private,58,0,273,0,0,331,331,59,0,335,0,0,394,394,3.238744227
34580,48.4932917,-121.8157703,40900,38.7896779,-121.0057504,private,19,0,101,0,0,120,120,24,11,124,0,11,148,159,3.092256255
33460,45.096664,-93.275361,48140,45.0539796,-89.7579047,private,32,0,170,0,0,202,202,51,0,203,0,0,254,254,3.151474797
16980,41.8235214,-87.8282967,36100,29.2028047,-82.0431004,private,99,96,196,0,96,295,391,110,115,183,0,115,293,408,3.24747117
49740,32.7739424,-113.910905,29620,42.7712334,-84.4960294,private,23,49,44,0,49,67,116,21,41,47,0,41,68,109,3.061088601
33100,26.1018281,-80.4787552,38060,33.1857653,-112.0678624,private,82,0,272,0,0,354,354,70,0,260,0,0,330,330,3.19884963
49740,32.7739424,-113.910905,41940,36.9084718,-121.3713721,private,0,45,80,0,45,80,125,16,27,89,0,27,105,132,3.075425722
19100,32.8491708,-96.9704894,41940,36.9084718,-121.3713721,private,48,0,264,0,0,312,312,34,0,199,0,0,233,233,3.138384382
26420,29.7495926,-95.3536422,22660,40.6580933,-105.4867638,private,42,0,108,0,0,150,150,15,11,78,0,11,93,104,3.057971836
35620,40.77493,-73.873758,30100,43.7857256,-72.1591415,private,0,0,64,0,0,64,64,42,138,243,0,138,285,423,3.256821466
35620,40.77493,-73.873758,11700,35.5956693,-82.6816145,private,0,0,122,0,0,122,122,43,23,385,0,23,428,451,3.274275352
37980,39.8949576,-75.3119824,40060,37.4113241,-77.4418164,private,19,0,189,0,0,208,208,12,0,219,0,0,231,231,3.137137676
37980,39.8949576,-75.3119824,29820,36.2142575,-115.013812,private,12,0,104,0,0,116,116,17,0,139,0,0,156,156,3.090386196
47900,38.7982054,-77.4868816,35840,27.3642461,-82.3193579,private,13,0,49,0,0,62,62,14,23,66,0,23,80,103,3.057348483
47900,38.7982054,-77.4868816,38060,33.1857653,-112.0678624,private,17,0,138,0,0,155,155,22,0,156,0,0,178,178,3.104099963
19100,32.8491708,-96.9704894,33740,32.734255,-92.0995498,private,26,0,152,0,0,178,178,41,0,193,0,0,234,234,3.139007735
26420,29.7495926,-95.3536422,28140,38.9318494,-94.4438241,private,43,0,168,0,0,211,211,39,0,179,0,0,218,218,3.129034086
31080,34.1087033,-118.1827533,41180,38.7402108,-90.3458253,private,14,0,235,0,0,249,249,0,0,328,0,0,328,328,3.197602924
43220,47.3541257,-123.1738498,12420,30.2395128,-97.6912697,private,52,0,63,0,0,115,115,40,0,127,0,0,167,167,3.097243079
33460,45.096664,-93.275361,36540,41.2904587,-95.9999701,private,26,0,166,0,0,192,192,30,0,147,0,0,177,177,3.10347661
49740,32.7739424,-113.910905,37100,34.3587415,-119.1331432,private,24,15,63,0,15,87,102,26,0,67,0,0,93,93,3.051114952
33100,26.1018281,-80.4787552,41860,37.7737185,-122.2744317,private,36,0,373,0,0,409,409,38,0,380,0,0,418,418,3.253704701
16980,41.8235214,-87.8282967,14020,39.2417362,-86.6717544,private,0,0,155,0,0,155,155,14,0,155,0,0,169,169,3.098489786
19100,32.8491708,-96.9704894,37340,28.2983112,-80.7003334,private,34,0,50,0,0,84,84,66,0,106,0,0,172,172,3.100359845
19100,32.8491708,-96.9704894,28140,38.9318494,-94.4438241,private,91,0,344,0,0,435,435,88,0,323,0,0,411,411,3.249341229
38060,33.1857653,-112.0678624,28420,46.3639636,-119.2540459,private,22,56,100,0,56,122,178,54,64,62,0,64,116,180,3.105346669
49740,32.7739424,-113.910905,42020,35.3852242,-120.4475445,private,18,31,43,0,31,61,92,20,16,66,0,16,86,102,3.05672513
31080,34.1087033,-118.1827533,14860,41.2274128,-73.3670614,private,13,0,84,0,0,97,97,13,0,161,0,0,174,174,3.101606551
31080,34.1087033,-118.1827533,17820,38.8455072,-104.6387277,private,67,0,316,0,0,383,383,101,0,372,0,0,473,473,3.28798912
41860,37.7737185,-122.2744317,39580,35.7567464,-78.4604412,private,51,0,175,0,0,226,226,58,0,254,0,0,312,312,3.187629275
42660,47.4905993,-121.833996,39580,35.7567464,-78.4604412,private,82,0,197,0,0,279,279,54,0,237,0,0,291,291,3.17453886
33100,26.1018281,-80.4787552,39100,41.5752737,-74.0338729,private,57,85,117,0,85,174,259,52,83,109,0,83,161,244,3.145241266
33460,45.096664,-93.275361,19780,41.5770501,-93.7597124,private,47,0,391,0,0,438,438,84,0,334,0,0,418,418,3.253704701
38060,33.1857653,-112.0678624,20740,44.9386719,-91.2843222,private,44,62,52,0,62,96,158,49,56,67,0,56,116,172,3.100359845
49740,32.7739424,-113.910905,34980,36.1181822,-86.6441196,private,55,0,108,0,0,163,163,51,0,102,0,0,153,153,3.088516136
42660,47.4905993,-121.833996,10740,35.1234965,-106.4583918,private,18,0,179,0,0,197,197,43,0,185,0,0,228,228,3.135267617
47900,38.7982054,-77.4868816,12700,41.7990145,-70.2118803,private,0,32,45,0,32,45,77,0,72,87,0,72,87,159,3.092256255
16980,41.8235214,-87.8282967,20220,42.4634808,-90.8787708,private,0,0,118,0,0,118,118,17,0,127,0,0,144,144,3.082905959
38060,33.1857653,-112.0678624,35840,27.3642461,-82.3193579,private,51,13,95,0,13,146,159,57,0,95,0,0,152,152,3.087892783
38060,33.1857653,-112.0678624,42020,35.3852242,-120.4475445,private,16,35,63,0,35,79,114,21,35,96,0,35,117,152,3.087892783
31080,34.1087033,-118.1827533,19820,42.7218478,-83.2008463,private,0,0,316,0,0,316,316,11,0,500,0,0,511,511,3.311676536
31080,34.1087033,-118.1827533,21340,31.527394,-105.5213326,private,94,0,231,0,0,325,325,59,0,267,0,0,326,326,3.196356218
31080,34.1087033,-118.1827533,22660,40.6580933,-105.4867638,private,60,0,206,0,0,266,266,43,0,324,0,0,367,367,3.221913694
12060,33.693728,-84.3999113,25720,40.6913977,-111.0527658,private,81,0,137,0,0,218,218,79,0,109,0,0,188,188,3.110333494
38060,33.1857653,-112.0678624,36260,41.276061,-113.126226,private,45,65,70,0,65,115,180,65,21,81,0,21,146,167,3.097243079
43220,47.3541257,-123.1738498,19100,32.8491708,-96.9704894,private,91,0,149,0,0,240,240,108,0,168,0,0,276,276,3.165188564
42660,47.4905993,-121.833996,21340,31.527394,-105.5213326,private,66,0,89,0,0,155,155,49,0,103,0,0,152,152,3.087892783
16980,41.8235214,-87.8282967,24860,34.6837085,-82.4134227,private,109,0,159,0,0,268,268,117,11,232,0,11,349,360,3.217550222
16980,41.8235214,-87.8282967,25940,32.3867916,-80.8308775,private,60,35,46,0,35,106,141,89,96,101,0,96,190,286,3.171422095
19100,32.8491708,-96.9704894,30780,34.7557726,-92.4005889,private,64,0,276,0,0,340,340,112,0,387,0,0,499,499,3.3041963
26420,29.7495926,-95.3536422,11460,42.2522168,-83.8434233,private,29,0,85,0,0,114,114,36,0,87,0,0,123,123,3.069815544
38060,33.1857653,-112.0678624,13740,45.6371402,-108.8323611,private,35,103,58,0,103,93,196,40,87,77,0,87,117,204,3.120307143
49740,32.7739424,-113.910905,20740,44.9386719,-91.2843222,private,21,45,22,0,45,43,88,34,35,31,0,35,65,100,3.055478423
49740,32.7739424,-113.910905,33940,38.3425479,-108.1622366,private,21,45,21,0,45,42,87,24,54,22,0,54,46,100,3.055478423
42660,47.4905993,-121.833996,41180,38.7402108,-90.3458253,private,24,0,186,0,0,210,210,33,0,193,0,0,226,226,3.134020911
33100,26.1018281,-80.4787552,41540,38.3995211,-75.4782615,private,23,60,57,0,60,80,140,21,53,52,0,53,73,126,3.071685603
19100,32.8491708,-96.9704894,19820,42.7218478,-83.2008463,private,46,0,246,0,0,292,292,45,0,244,0,0,289,289,3.173292154
49740,32.7739424,-113.910905,30700,40.8174581,-96.8687434,private,39,42,43,0,42,82,124,43,36,32,0,36,75,111,3.062335307
14460,42.517606,-71.0219925,39100,41.5752737,-74.0338729,private,0,0,80,0,0,80,80,12,12,144,0,12,156,168,3.097866432
14460,42.517606,-71.0219925,41620,40.5728869,-112.9532527,private,0,0,63,0,0,63,63,18,0,81,0,0,99,99,3.05485507
19100,32.8491708,-96.9704894,28780,27.1139432,-97.5685077,private,17,0,81,0,0,98,98,30,0,124,0,0,154,154,3.089139489
26420,29.7495926,-95.3536422,37860,30.6554013,-87.1618275,private,55,0,105,0,0,160,160,50,0,125,0,0,175,175,3.102229904
49740,32.7739424,-113.910905,17020,39.6659588,-121.6019188,private,18,35,24,0,35,42,77,21,34,44,0,34,65,99,3.05485507
31080,34.1087033,-118.1827533,38300,40.4395249,-79.8360972,private,0,0,114,0,0,114,114,11,0,169,0,0,180,180,3.105346669
33100,26.1018281,-80.4787552,12580,39.304361,-76.5495009,private,85,77,236,0,77,321,398,55,59,244,0,59,299,358,3.216303516
16980,41.8235214,-87.8282967,47260,36.8044077,-76.4495261,private,60,0,256,0,0,316,316,48,0,251,0,0,299,299,3.179525685
26420,29.7495926,-95.3536422,33460,45.096664,-93.275361,private,33,0,191,0,0,224,224,26,0,185,0,0,211,211,3.124670615
38060,33.1857653,-112.0678624,39900,40.5007953,-119.7311608,private,40,24,90,0,24,130,154,20,21,70,0,21,90,111,3.062335307
49740,32.7739424,-113.910905,39820,40.7605142,-122.0435556,private,21,20,57,0,20,78,98,25,23,36,0,23,61,84,3.045504774
37980,39.8949576,-75.3119824,18140,39.9685617,-82.8359105,private,0,0,142,0,0,142,142,25,0,152,0,0,177,177,3.10347661
33100,26.1018281,-80.4787552,47260,36.8044077,-76.4495261,private,72,0,179,0,0,251,251,37,13,203,0,13,240,253,3.150851444
38060,33.1857653,-112.0678624,23340,41.5770082,-96.6458526,private,26,46,42,0,46,68,114,47,42,53,0,42,100,142,3.081659253
49740,32.7739424,-113.910905,17460,41.7603919,-81.7242168,private,36,55,75,0,55,111,166,48,48,72,0,48,120,168,3.097866432
42660,47.4905993,-121.833996,22660,40.6580933,-105.4867638,private,52,0,149,0,0,201,201,40,14,163,0,14,203,217,3.128410733
14460,42.517606,-71.0219925,29460,27.9536488,-81.6935337,private,14,11,54,18,29,68,97,16,12,52,0,12,68,80,3.043011362
12060,33.693728,-84.3999113,25060,30.4801526,-88.9992972,private,58,0,162,0,0,220,220,46,0,177,0,0,223,223,3.132150851
20900,29.2784805,-96.2296745,33100,26.1018281,-80.4787552,private,67,0,162,0,0,229,229,68,0,183,0,0,251,251,3.149604737
38060,33.1857653,-112.0678624,33700,37.5623162,-121.0028311,private,23,0,138,0,0,161,161,38,0,134,0,0,172,172,3.100359845
19100,32.8491708,-96.9704894,35380,29.805532,-89.7013821,private,93,0,306,0,0,399,399,58,0,301,0,0,359,359,3.216926869
31080,34.1087033,-118.1827533,26900,39.74867,-86.2123823,private,0,0,210,0,0,210,210,39,0,327,0,0,366,366,3.221290341
41860,37.7737185,-122.2744317,11460,42.2522168,-83.8434233,private,25,0,118,0,0,143,143,13,0,153,0,0,166,166,3.096619726
43220,47.3541257,-123.1738498,28660,31.2027301,-97.7896384,private,39,0,45,0,0,84,84,47,0,50,0,0,97,97,3.053608364
33460,45.096664,-93.275361,41860,37.7737185,-122.2744317,private,55,0,437,0,0,492,492,27,0,330,0,0,357,357,3.215680163
19100,32.8491708,-96.9704894,33460,45.096664,-93.275361,private,93,0,298,0,0,391,391,74,11,285,0,11,359,370,3.223783753
14460,42.517606,-71.0219925,25720,40.6913977,-111.0527658,private,0,0,49,0,0,49,49,32,0,64,0,0,96,96,3.052985011
37980,39.8949576,-75.3119824,27780,40.5102221,-78.7104783,private,23,0,86,0,0,109,109,22,0,91,0,0,113,113,3.063582013
16980,41.8235214,-87.8282967,10740,35.1234965,-106.4583918,private,24,0,183,0,0,207,207,11,0,198,0,0,209,209,3.123423908
19100,32.8491708,-96.9704894,38900,45.6006221,-122.484378,private,68,0,287,0,0,355,355,57,0,286,0,0,343,343,3.20695322
38060,33.1857653,-112.0678624,27260,30.2365943,-81.7544462,private,59,0,159,0,0,218,218,63,0,192,0,0,255,255,3.15209815
38060,33.1857653,-112.0678624,20900,29.2784805,-96.2296745,private,41,0,96,0,0,137,137,63,0,123,0,0,186,186,3.109086788
41860,37.7737185,-122.2744317,20900,29.2784805,-96.2296745,private,15,0,79,0,0,94,94,21,0,165,0,0,186,186,3.109086788
41860,37.7737185,-122.2744317,22660,40.6580933,-105.4867638,private,22,0,81,0,0,103,103,41,12,115,0,12,156,168,3.097866432
41860,37.7737185,-122.2744317,17460,41.7603919,-81.7242168,private,0,0,83,0,0,83,83,25,0,148,0,0,173,173,3.100983198
37980,39.8949576,-75.3119824,33460,45.096664,-93.275361,private,11,0,155,0,0,166,166,0,0,137,0,0,137,137,3.078542487
19100,32.8491708,-96.9704894,11460,42.2522168,-83.8434233,private,37,0,135,0,0,172,172,23,0,135,0,0,158,158,3.091632902
20900,29.2784805,-96.2296745,42660,47.4905993,-121.833996,private,29,0,122,0,0,151,151,24,0,116,0,0,140,140,3.080412546
49740,32.7739424,-113.910905,24300,39.019524,-108.4605707,private,38,21,36,0,21,74,95,36,29,28,0,29,64,93,3.051114952
35620,40.77493,-73.873758,42200,34.5370572,-120.0399729,private,0,0,71,0,0,71,71,17,15,135,0,15,152,167,3.097243079
47900,38.7982054,-77.4868816,41180,38.7402108,-90.3458253,private,11,0,70,0,0,81,81,15,0,124,0,0,139,139,3.079789193
12060,33.693728,-84.3999113,23540,29.4807065,-82.6274667,private,53,0,157,0,0,210,210,59,0,170,0,0,229,229,3.13589097
16980,41.8235214,-87.8282967,19430,39.8288538,-84.1418129,private,0,0,90,0,0,90,90,27,0,207,0,0,234,234,3.139007735
49740,32.7739424,-113.910905,22020,46.9148591,-96.9601826,private,35,61,29,0,61,64,125,29,59,26,0,59,55,114,3.064205367
33460,45.096664,-93.275361,37860,30.6554013,-87.1618275,private,24,139,64,0,139,88,227,14,97,45,0,97,59,156,3.090386196
49740,32.7739424,-113.910905,26900,39.74867,-86.2123823,private,78,57,101,0,57,179,236,61,37,103,0,37,164,201,3.118437084
49740,32.7739424,-113.910905,16220,42.9776447,-106.7682192,private,14,61,19,0,61,33,94,24,50,16,0,50,40,90,3.049244893
35620,40.77493,-73.873758,42540,41.3228806,-75.8981877,private,49,0,291,0,0,340,340,70,16,455,0,16,525,541,3.330377129
12060,33.693728,-84.3999113,41180,38.7402108,-90.3458253,private,59,0,295,0,0,354,354,40,0,331,0,0,371,371,3.224407106
49740,32.7739424,-113.910905,35100,35.1168292,-77.0813197,private,27,0,44,0,0,71,71,48,0,46,0,0,94,94,3.051738305
49740,32.7739424,-113.910905,24580,44.4740244,-87.9961303,private,50,91,36,0,91,86,177,57,87,41,0,87,98,185,3.108463435
42660,47.4905993,-121.833996,42200,34.5370572,-120.0399729,private,11,0,69,0,0,80,80,18,25,81,0,25,99,124,3.070438897
38060,33.1857653,-112.0678624,37100,34.3587415,-119.1331432,private,19,0,153,0,0,172,172,22,0,121,0,0,143,143,3.082282606
49740,32.7739424,-113.910905,24340,43.0375977,-85.7781669,private,31,44,43,0,44,74,118,32,25,42,0,25,74,99,3.05485507
47900,38.7982054,-77.4868816,35300,41.3497185,-72.9002033,private,0,0,100,0,0,100,100,0,0,152,0,0,152,152,3.087892783
12060,33.693728,-84.3999113,26620,34.7832617,-86.7348706,private,60,0,136,0,0,196,196,46,0,180,0,0,226,226,3.134020911
33100,26.1018281,-80.4787552,28940,36.0147907,-84.2067014,private,39,37,126,0,37,165,202,62,26,187,0,26,249,275,3.164565211
38060,33.1857653,-112.0678624,37860,30.6554013,-87.1618275,private,29,44,91,0,44,120,164,49,12,101,0,12,150,162,3.094126314
14460,42.517606,-71.0219925,27260,30.2365943,-81.7544462,private,0,0,109,13,13,109,122,24,12,120,0,12,144,156,3.090386196
33100,26.1018281,-80.4787552,22180,35.1559863,-78.93185,private,44,0,114,0,0,158,158,44,0,123,0,0,167,167,3.097243079
38060,33.1857653,-112.0678624,36740,28.4343962,-81.3560839,private,75,0,282,0,0,357,357,74,0,293,0,0,367,367,3.221913694
14460,42.517606,-71.0219925,18140,39.9685617,-82.8359105,private,16,0,106,0,0,122,122,30,0,131,0,0,161,161,3.093502961
14460,42.517606,-71.0219925,41700,29.4330599,-98.6069734,private,17,0,49,0,0,66,66,16,0,76,0,0,92,92,3.050491599
37980,39.8949576,-75.3119824,35300,41.3497185,-72.9002033,private,0,0,143,0,0,143,143,12,0,179,0,0,191,191,3.112203553
37980,39.8949576,-75.3119824,42540,41.3228806,-75.8981877,private,23,0,218,0,0,241,241,67,11,350,0,11,417,428,3.259938231
12060,33.693728,-84.3999113,24660,36.0252039,-79.7926333,private,83,0,328,0,0,411,411,111,0,408,0,0,519,519,3.316663361
16980,41.8235214,-87.8282967,28940,36.0147907,-84.2067014,private,234,0,404,0,0,638,638,290,0,464,0,0,754,754,3.463151333
16980,41.8235214,-87.8282967,17820,38.8455072,-104.6387277,private,67,0,239,0,0,306,306,93,0,232,0,0,325,325,3.195732865
38060,33.1857653,-112.0678624,24580,44.4740244,-87.9961303,private,64,123,78,0,123,142,265,75,120,95,0,120,170,290,3.173915507
41860,37.7737185,-122.2744317,49740,32.7739424,-113.910905,private,24,0,94,0,0,118,118,24,0,132,0,0,156,156,3.090386196
14460,42.517606,-71.0219925,45940,40.2825026,-74.703724,private,14,0,92,0,0,106,106,0,0,95,0,0,95,95,3.052361658
19100,32.8491708,-96.9704894,12580,39.304361,-76.5495009,private,23,0,210,0,0,233,233,13,0,190,0,0,203,203,3.11968379
19100,32.8491708,-96.9704894,41620,40.5728869,-112.9532527,private,21,0,104,0,0,125,125,0,0,82,0,0,82,82,3.044258068
33100,26.1018281,-80.4787552,46660,30.8271579,-83.2435547,private,51,0,87,0,0,138,138,38,0,107,0,0,145,145,3.083529312
26420,29.7495926,-95.3536422,12580,39.304361,-76.5495009,private,12,0,161,0,0,173,173,11,0,135,0,0,146,146,3.084152665
38060,33.1857653,-112.0678624,33940,38.3425479,-108.1622366,private,11,83,50,0,83,61,144,25,74,71,0,74,96,170,3.099113139
49740,32.7739424,-113.910905,23340,41.5770082,-96.6458526,private,27,52,11,0,52,38,90,20,44,25,0,44,45,89,3.04862154
14460,42.517606,-71.0219925,20900,29.2784805,-96.2296745,private,0,0,47,0,0,47,47,17,0,73,0,0,90,90,3.049244893
35620,40.77493,-73.873758,42340,32.1091533,-81.2731066,private,0,0,66,0,0,66,66,27,13,132,0,13,159,172,3.100359845
35620,40.77493,-73.873758,26900,39.74867,-86.2123823,private,0,0,364,0,0,364,364,27,16,496,0,16,523,539,3.329130422
19100,32.8491708,-96.9704894,48620,37.637896,-97.2462875,private,11,0,142,0,0,153,153,23,0,129,0,0,152,152,3.087892783
26420,29.7495926,-95.3536422,24860,34.6837085,-82.4134227,private,19,0,65,0,0,84,84,40,0,81,0,0,121,121,3.068568838
31080,34.1087033,-118.1827533,35840,27.3642461,-82.3193579,private,29,0,153,0,0,182,182,37,0,217,0,0,254,254,3.151474797
42660,47.4905993,-121.833996,33700,37.5623162,-121.0028311,private,28,0,122,0,0,150,150,47,0,119,0,0,166,166,3.096619726
42660,47.4905993,-121.833996,18140,39.9685617,-82.8359105,private,31,0,167,0,0,198,198,14,0,202,0,0,216,216,3.12778738
14460,42.517606,-71.0219925,40060,37.4113241,-77.4418164,private,11,0,99,0,0,110,110,12,0,117,0,0,129,129,3.073555663
16980,41.8235214,-87.8282967,40060,37.4113241,-77.4418164,private,28,0,157,0,0,185,185,11,0,179,0,0,190,190,3.1115802
19100,32.8491708,-96.9704894,40140,34.5384763,-116.1345414,private,49,0,206,0,0,255,255,33,0,239,0,0,272,272,3.162695152
31080,34.1087033,-118.1827533,12580,39.304361,-76.5495009,private,28,0,245,0,0,273,273,11,0,283,0,0,294,294,3.17640892
14460,42.517606,-71.0219925,28300,42.9254596,-72.2481828,private,0,0,48,15,15,48,63,13,16,60,0,16,73,89,3.04862154
35620,40.77493,-73.873758,13780,42.1639276,-76.0229431,private,11,0,105,0,0,116,116,0,0,191,0,0,191,191,3.112203553
16980,41.8235214,-87.8282967,22220,36.1163935,-94.0795449,private,86,0,151,0,0,237,237,67,0,151,0,0,218,218,3.129034086
19100,32.8491708,-96.9704894,37260,29.5938964,-81.7320389,private,28,0,65,0,0,93,93,40,0,99,0,0,139,139,3.079789193
38060,33.1857653,-112.0678624,32380,43.2137325,-93.2743388,private,20,54,35,0,54,55,109,52,43,41,0,43,93,136,3.077919134
41860,37.7737185,-122.2744317,32780,42.4116214,-122.6756106,private,21,0,81,0,0,102,102,36,0,117,0,0,153,153,3.088516136
42660,47.4905993,-121.833996,38300,40.4395249,-79.8360972,private,0,0,108,0,0,108,108,15,0,151,0,0,166,166,3.096619726
42660,47.4905993,-121.833996,31540,43.0842941,-89.5971796,private,0,0,143,0,0,143,143,15,0,134,0,0,149,149,3.086022724
26420,29.7495926,-95.3536422,33340,43.0176601,-87.4815541,private,17,0,95,0,0,112,112,14,0,81,0,0,95,95,3.052361658
38060,33.1857653,-112.0678624,29940,38.8964168,-95.2909475,private,21,17,86,0,17,107,124,26,12,65,0,12,91,103,3.057348483
14460,42.517606,-71.0219925,37260,29.5938964,-81.7320389,private,14,0,32,28,28,46,74,18,15,55,0,15,73,88,3.047998187
37980,39.8949576,-75.3119824,22180,35.1559863,-78.93185,private,28,0,83,0,0,111,111,29,0,113,0,0,142,142,3.081659253
12060,33.693728,-84.3999113,43900,34.9332708,-81.9910522,private,49,0,117,0,0,166,166,47,0,129,0,0,176,176,3.102853257
33100,26.1018281,-80.4787552,17820,38.8455072,-104.6387277,private,13,0,90,0,0,103,103,37,0,135,0,0,172,172,3.100359845
14460,42.517606,-71.0219925,14500,40.0949699,-105.3976911,private,0,0,87,0,0,87,87,13,0,69,0,0,82,82,3.044258068
34580,48.4932917,-121.8157703,12420,30.2395128,-97.6912697,private,61,0,96,0,0,157,157,59,0,99,0,0,158,158,3.091632902
35620,40.77493,-73.873758,31140,38.3058381,-85.6816455,private,11,0,114,0,0,125,125,11,0,214,0,0,225,225,3.133397558
20900,29.2784805,-96.2296745,19740,39.434789,-104.9010728,private,93,0,159,0,0,252,252,86,0,150,0,0,236,236,3.140254441
41860,37.7737185,-122.2744317,41700,29.4330599,-98.6069734,private,13,0,72,0,0,85,85,24,0,142,0,0,166,166,3.096619726
41860,37.7737185,-122.2744317,19820,42.7218478,-83.2008463,private,0,0,106,0,0,106,106,22,0,266,0,0,288,288,3.172668801
12060,33.693728,-84.3999113,19430,39.8288538,-84.1418129,private,27,0,153,0,0,180,180,13,0,165,0,0,178,178,3.104099963
49740,32.7739424,-113.910905,40300,42.041884,-89.3201764,private,24,43,19,0,43,43,86,28,31,18,0,31,46,77,3.041141303
34580,48.4932917,-121.8157703,47260,36.8044077,-76.4495261,private,44,0,102,0,0,146,146,51,0,70,0,0,121,121,3.068568838
35620,40.77493,-73.873758,32820,35.0244194,-89.8719712,private,0,0,91,0,0,91,91,0,14,106,0,14,106,120,3.067945485
47900,38.7982054,-77.4868816,49020,39.2729744,-78.4718276,private,0,0,34,0,0,34,34,11,12,63,0,12,74,86,3.04675148
12060,33.693728,-84.3999113,35900,36.2088833,-81.1660949,private,29,11,86,0,11,115,126,53,11,109,0,11,162,173,3.100983198
33460,45.096664,-93.275361,37340,28.2983112,-80.7003334,private,27,73,63,0,73,90,163,12,83,87,0,83,99,182,3.106593375
33460,45.096664,-93.275361,41700,29.4330599,-98.6069734,private,30,0,114,0,0,144,144,54,0,161,0,0,215,215,3.127164027
38060,33.1857653,-112.0678624,38500,41.3250032,-86.2690363,private,28,46,43,0,46,71,117,27,46,71,0,46,98,144,3.082905959
38060,33.1857653,-112.0678624,32780,42.4116214,-122.6756106,private,52,28,108,0,28,160,188,46,14,112,0,14,158,172,3.100359845
49740,32.7739424,-113.910905,38500,41.3250032,-86.2690363,private,15,29,30,0,29,45,74,21,27,38,0,27,59,86,3.04675148
31080,34.1087033,-118.1827533,16700,33.0180695,-80.0075006,private,0,0,90,0,0,90,90,22,0,189,0,0,211,211,3.124670615
31080,34.1087033,-118.1827533,10140,47.1137324,-123.8267349,private,17,0,174,0,0,191,191,31,12,227,0,12,258,270,3.161448446
12060,33.693728,-84.3999113,41940,36.9084718,-121.3713721,private,50,0,249,0,0,299,299,0,11,156,0,11,156,167,3.097243079
33100,26.1018281,-80.4787552,25720,40.6913977,-111.0527658,private,42,0,105,0,0,147,147,22,11,101,0,11,123,134,3.076672428
26420,29.7495926,-95.3536422,38300,40.4395249,-79.8360972,private,39,0,120,0,0,159,159,17,0,96,0,0,113,113,3.063582013
38060,33.1857653,-112.0678624,14010,40.4945594,-88.8445391,private,20,46,45,0,46,65,111,33,25,40,0,25,73,98,3.054231717
49740,32.7739424,-113.910905,45000,40.7210862,-120.6299518,private,16,52,17,0,52,33,85,13,52,15,0,52,28,80,3.043011362
35620,40.77493,-73.873758,28140,38.9318494,-94.4438241,private,0,0,118,0,0,118,118,30,0,325,0,0,355,355,3.214433457
12060,33.693728,-84.3999113,38300,40.4395249,-79.8360972,private,40,0,230,0,0,270,270,34,0,232,0,0,266,266,3.158955034
33100,26.1018281,-80.4787552,48900,34.4260331,-77.889634,private,23,12,58,0,12,81,93,23,16,74,0,16,97,113,3.063582013
33460,45.096664,-93.275361,48580,42.6681095,-88.5417306,private,13,0,135,0,0,148,148,17,0,140,0,0,157,157,3.091009549
16980,41.8235214,-87.8282967,14860,41.2274128,-73.3670614,private,27,0,98,0,0,125,125,0,0,144,0,0,144,144,3.082905959
38060,33.1857653,-112.0678624,45300,28.1259071,-82.4652858,private,105,0,356,0,0,461,461,92,0,442,0,0,534,534,3.326013657
42660,47.4905993,-121.833996,16700,33.0180695,-80.0075006,private,52,0,107,0,0,159,159,42,0,147,0,0,189,189,3.110956847
43220,47.3541257,-123.1738498,22180,35.1559863,-78.93185,private,34,0,39,0,0,73,73,40,0,45,0,0,85,85,3.046128127
43220,47.3541257,-123.1738498,17820,38.8455072,-104.6387277,private,29,0,55,0,0,84,84,25,0,60,0,0,85,85,3.046128127
26420,29.7495926,-95.3536422,22220,36.1163935,-94.0795449,private,23,0,83,0,0,106,106,34,0,86,0,0,120,120,3.067945485
49740,32.7739424,-113.910905,18140,39.9685617,-82.8359105,private,36,52,78,0,52,114,166,34,20,88,0,20,122,142,3.081659253
34580,48.4932917,-121.8157703,12540,35.3466288,-118.7295064,private,37,0,61,0,0,98,98,28,0,78,0,0,106,106,3.059218542
35620,40.77493,-73.873758,22660,40.6580933,-105.4867638,private,0,0,78,0,0,78,78,11,0,153,0,0,164,164,3.09537302
35620,40.77493,-73.873758,36100,29.2028047,-82.0431004,private,36,0,162,0,0,198,198,45,0,232,0,0,277,277,3.165811917
35620,40.77493,-73.873758,31700,42.9115317,-71.7230554,private,0,0,132,0,0,132,132,12,12,246,0,12,258,270,3.161448446
37980,39.8949576,-75.3119824,47260,36.8044077,-76.4495261,private,50,0,207,0,0,257,257,27,0,247,0,0,274,274,3.163941858
47900,38.7982054,-77.4868816,34940,26.118786,-81.4009553,private,0,12,23,0,12,23,35,19,21,44,0,21,63,84,3.045504774
12060,33.693728,-84.3999113,42460,34.764114,-85.9800556,private,72,0,124,0,0,196,196,66,0,163,0,0,229,229,3.13589097
33100,26.1018281,-80.4787552,15620,44.3287385,-85.3264287,private,25,29,0,0,29,25,54,19,44,21,0,44,40,84,3.045504774
49740,32.7739424,-113.910905,46380,39.4323876,-123.4428811,private,12,31,34,0,31,46,77,13,28,43,0,28,56,84,3.045504774
31080,34.1087033,-118.1827533,36740,28.4343962,-81.3560839,private,52,0,410,0,0,462,462,66,0,486,0,0,552,552,3.337234012
14460,42.517606,-71.0219925,40380,43.148038,-77.5232575,private,0,0,127,0,0,127,127,0,0,165,0,0,165,165,3.095996373
47900,38.7982054,-77.4868816,35380,29.805532,-89.7013821,private,0,0,97,0,0,97,97,0,0,72,0,0,72,72,3.038024537
49740,32.7739424,-113.910905,10420,41.1466395,-81.3501104,private,18,45,32,0,45,50,95,17,17,35,0,17,52,69,3.036154478
42660,47.4905993,-121.833996,29420,35.717705,-113.7496891,private,23,22,67,0,22,90,112,15,18,64,0,18,79,97,3.053608364
37980,39.8949576,-75.3119824,49620,39.9217514,-76.7288887,private,14,0,199,0,0,213,213,34,0,188,0,0,222,222,3.131527498
33100,26.1018281,-80.4787552,18140,39.9685617,-82.8359105,private,35,28,185,0,28,220,248,74,24,189,0,24,263,287,3.172045448
38060,33.1857653,-112.0678624,23620,33.6391964,-97.2103433,private,45,0,105,0,0,150,150,50,0,99,0,0,149,149,3.086022724
31080,34.1087033,-118.1827533,27260,30.2365943,-81.7544462,private,11,0,190,0,0,201,201,12,0,270,0,0,282,282,3.168928683
31080,34.1087033,-118.1827533,28140,38.9318494,-94.4438241,private,11,0,272,0,0,283,283,23,0,283,0,0,306,306,3.183889156
34580,48.4932917,-121.8157703,32780,42.4116214,-122.6756106,private,20,0,34,0,0,54,54,29,0,54,0,0,83,83,3.044881421
37980,39.8949576,-75.3119824,41700,29.4330599,-98.6069734,private,20,0,87,0,0,107,107,14,0,87,0,0,101,101,3.056101777
26420,29.7495926,-95.3536422,17140,39.0998213,-84.4804072,private,21,0,88,0,0,109,109,13,0,81,0,0,94,94,3.051738305
38060,33.1857653,-112.0678624,16300,42.0863293,-91.6311439,private,75,118,118,0,118,193,311,91,82,134,0,82,225,307,3.18451251
42660,47.4905993,-121.833996,32780,42.4116214,-122.6756106,private,19,0,127,0,0,146,146,36,0,141,0,0,177,177,3.10347661
14460,42.517606,-71.0219925,40860,43.5808577,-73.0382023,private,0,0,35,13,13,35,48,14,19,49,0,19,63,82,3.044258068
35620,40.77493,-73.873758,29060,43.5191091,-71.4253661,private,0,0,31,0,0,31,31,0,49,101,0,49,101,150,3.086646077
16980,41.8235214,-87.8282967,48140,45.0539796,-89.7579047,private,52,0,176,0,0,228,228,87,29,190,0,29,277,306,3.183889156
26420,29.7495926,-95.3536422,33740,32.734255,-92.0995498,private,16,0,69,0,0,85,85,22,0,97,0,0,119,119,3.067322132
38060,33.1857653,-112.0678624,24340,43.0375977,-85.7781669,private,66,71,108,0,71,174,245,37,47,97,0,47,134,181,3.105970022
31080,34.1087033,-118.1827533,39900,40.5007953,-119.7311608,private,63,0,173,0,0,236,236,77,0,242,0,0,319,319,3.191992746
41860,37.7737185,-122.2744317,41180,38.7402108,-90.3458253,private,11,0,86,0,0,97,97,12,0,140,0,0,152,152,3.087892783
12060,33.693728,-84.3999113,28660,31.2027301,-97.7896384,private,57,0,127,0,0,184,184,53,0,163,0,0,216,216,3.12778738
16980,41.8235214,-87.8282967,40340,43.9496362,-92.3360701,private,18,0,126,0,0,144,144,0,0,137,0,0,137,137,3.078542487
20900,29.2784805,-96.2296745,38060,33.1857653,-112.0678624,private,47,0,84,0,0,131,131,38,0,99,0,0,137,137,3.078542487
38060,33.1857653,-112.0678624,14460,42.517606,-71.0219925,private,0,91,346,0,91,346,437,27,41,275,0,41,302,343,3.20695322
35620,40.77493,-73.873758,40860,43.5808577,-73.0382023,private,0,0,18,0,0,18,18,0,59,82,0,59,82,141,3.081035899
37980,39.8949576,-75.3119824,11460,42.2522168,-83.8434233,private,0,0,84,0,0,84,84,14,0,87,0,0,101,101,3.056101777
47900,38.7982054,-77.4868816,15540,44.6891168,-73.0411707,private,0,0,37,0,0,37,37,11,0,70,0,0,81,81,3.043634715
16980,41.8235214,-87.8282967,40900,38.7896779,-121.0057504,private,34,0,255,0,0,289,289,14,0,281,0,0,295,295,3.177032273
19100,32.8491708,-96.9704894,18140,39.9685617,-82.8359105,private,38,0,181,0,0,219,219,50,0,166,0,0,216,216,3.12778738
38060,33.1857653,-112.0678624,47940,42.5367962,-92.471608,private,57,67,60,0,67,117,184,56,52,40,0,52,96,148,3.085399371
38060,33.1857653,-112.0678624,48620,37.637896,-97.2462875,private,28,12,85,0,12,113,125,40,17,76,0,17,116,133,3.076049075
12060,33.693728,-84.3999113,35100,35.1168292,-77.0813197,private,36,0,137,0,0,173,173,48,0,173,0,0,221,221,3.130904145
19100,32.8491708,-96.9704894,29940,38.8964168,-95.2909475,private,29,0,73,0,0,102,102,17,0,70,0,0,87,87,3.047374834
38060,33.1857653,-112.0678624,39300,41.7068313,-71.2866369,private,12,54,89,0,54,101,155,0,41,84,0,41,84,125,3.07106225
49740,32.7739424,-113.910905,22140,36.5116245,-108.3245778,private,20,20,40,0,20,60,80,17,13,14,0,13,31,44,3.020570651
35620,40.77493,-73.873758,33340,43.0176601,-87.4815541,private,0,0,137,0,0,137,137,0,0,268,0,0,268,268,3.16020174
33460,45.096664,-93.275361,36740,28.4343962,-81.3560839,private,48,73,210,0,73,258,331,66,100,184,0,100,250,350,3.211316692
33460,45.096664,-93.275361,17820,38.8455072,-104.6387277,private,15,0,163,0,0,178,178,51,0,155,0,0,206,206,3.121553849
26420,29.7495926,-95.3536422,25060,30.4801526,-88.9992972,private,43,0,80,0,0,123,123,48,0,100,0,0,148,148,3.085399371
38060,33.1857653,-112.0678624,36420,35.4309676,-97.5069659,private,64,11,169,0,11,233,244,109,0,205,0,0,314,314,3.188875981
43220,47.3541257,-123.1738498,32780,42.4116214,-122.6756106,private,22,0,48,0,0,70,70,23,0,57,0,0,80,80,3.043011362
33100,26.1018281,-80.4787552,25420,40.335915,-77.0504897,private,0,18,45,0,18,45,63,35,15,80,0,15,115,130,3.074179016
33100,26.1018281,-80.4787552,10500,31.6444531,-84.1119078,private,26,0,74,0,0,100,100,37,0,110,0,0,147,147,3.084776018
26420,29.7495926,-95.3536422,18140,39.9685617,-82.8359105,private,32,0,117,0,0,149,149,15,0,105,0,0,120,120,3.067945485
41860,37.7737185,-122.2744317,21700,40.7066554,-123.9261757,private,0,0,55,0,0,55,55,11,0,121,0,0,132,132,3.075425722
19100,32.8491708,-96.9704894,43220,47.3541257,-123.1738498,private,34,0,74,0,0,108,108,23,0,73,0,0,96,96,3.052985011
42660,47.4905993,-121.833996,16740,35.1663423,-80.7972848,private,71,0,135,0,0,206,206,58,0,202,0,0,260,260,3.155214915
42660,47.4905993,-121.833996,37100,34.3587415,-119.1331432,private,18,0,124,0,0,142,142,16,0,95,0,0,111,111,3.062335307
34580,48.4932917,-121.8157703,39150,34.631071,-112.5772247,private,26,26,26,0,26,52,78,17,20,37,0,20,54,74,3.039271244
35620,40.77493,-73.873758,37100,34.3587415,-119.1331432,private,0,0,57,0,0,57,57,11,0,107,0,0,118,118,3.066698779
37980,39.8949576,-75.3119824,20660,38.7483486,-76.1784757,private,15,0,40,0,0,55,55,31,19,56,0,19,87,106,3.059218542
37980,39.8949576,-75.3119824,36380,27.3855924,-80.8873884,private,26,30,64,0,30,90,120,20,31,61,0,31,81,112,3.06295866
37980,39.8949576,-75.3119824,39060,40.703682,-76.2177878,private,0,0,44,0,0,44,44,17,0,80,0,0,97,97,3.053608364
33460,45.096664,-93.275361,20900,29.2784805,-96.2296745,private,16,0,85,0,0,101,101,42,0,103,0,0,145,145,3.083529312
19100,32.8491708,-96.9704894,36540,41.2904587,-95.9999701,private,18,0,84,0,0,102,102,34,0,133,0,0,167,167,3.097243079
41860,37.7737185,-122.2744317,14260,43.0066485,-116.1419089,private,42,0,125,0,0,167,167,61,0,192,0,0,253,253,3.150851444
42660,47.4905993,-121.833996,39150,34.631071,-112.5772247,private,18,0,69,0,0,87,87,44,0,101,0,0,145,145,3.083529312
37980,39.8949576,-75.3119824,20500,36.0605886,-78.9897875,private,12,0,89,0,0,101,101,0,0,62,0,0,62,62,3.031791007
33100,26.1018281,-80.4787552,15380,43.0443711,-78.7773351,private,25,71,64,0,71,89,160,35,47,94,0,47,129,176,3.102853257
38060,33.1857653,-112.0678624,14500,40.0949699,-105.3976911,private,17,29,31,0,29,48,77,13,23,38,0,23,51,74,3.039271244
38060,33.1857653,-112.0678624,49420,46.4565581,-120.7401446,private,41,57,31,0,57,72,129,34,40,40,0,40,74,114,3.064205367
49740,32.7739424,-113.910905,21580,36.5096687,-106.6939829,private,19,35,23,0,35,42,77,11,25,31,0,25,42,67,3.034907772
35620,40.77493,-73.873758,49340,42.2173112,-71.9255354,private,0,0,219,0,0,219,219,22,33,433,0,33,455,488,3.297339416
35620,40.77493,-73.873758,13820,33.4025986,-86.7295151,private,0,0,77,0,0,77,77,25,0,128,0,0,153,153,3.088516136
37980,39.8949576,-75.3119824,48900,34.4260331,-77.889634,private,21,0,55,0,0,76,76,18,12,68,0,12,86,98,3.054231717
12060,33.693728,-84.3999113,15140,35.5866782,-89.2826913,private,33,0,115,0,0,148,148,35,0,112,0,0,147,147,3.084776018
16980,41.8235214,-87.8282967,11700,35.5956693,-82.6816145,private,30,0,148,0,0,178,178,77,0,238,0,0,315,315,3.189499334
19100,32.8491708,-96.9704894,16700,33.0180695,-80.0075006,private,26,0,82,0,0,108,108,26,0,126,0,0,152,152,3.087892783
31080,34.1087033,-118.1827533,21700,40.7066554,-123.9261757,private,0,0,110,0,0,110,110,0,0,192,0,0,192,192,3.112826906
41860,37.7737185,-122.2744317,40700,43.2863277,-123.154476,private,15,0,111,0,0,126,126,18,0,132,0,0,150,150,3.086646077
42660,47.4905993,-121.833996,14500,40.0949699,-105.3976911,private,12,0,72,0,0,84,84,0,0,103,0,0,103,103,3.057348483
43220,47.3541257,-123.1738498,39150,34.631071,-112.5772247,private,16,11,37,0,11,53,64,17,21,39,0,21,56,77,3.041141303
16980,41.8235214,-87.8282967,23620,33.6391964,-97.2103433,private,92,0,129,0,0,221,221,86,0,123,0,0,209,209,3.123423908
26420,29.7495926,-95.3536422,41620,40.5728869,-112.9532527,private,21,0,55,0,0,76,76,16,0,68,0,0,84,84,3.045504774
26420,29.7495926,-95.3536422,21580,36.5096687,-106.6939829,private,19,15,42,0,15,61,76,19,23,29,0,23,48,71,3.037401184
38060,33.1857653,-112.0678624,12580,39.304361,-76.5495009,private,17,16,133,0,16,150,166,23,0,129,0,0,152,152,3.087892783
49740,32.7739424,-113.910905,39580,35.7567464,-78.4604412,private,26,0,64,0,0,90,90,27,0,50,0,0,77,77,3.041141303
49740,32.7739424,-113.910905,19340,41.3916799,-90.460076,private,49,65,33,0,65,82,147,35,61,18,0,61,53,114,3.064205367
34580,48.4932917,-121.8157703,26420,29.7495926,-95.3536422,private,33,17,70,0,17,103,120,19,11,67,0,11,86,97,3.053608364
43220,47.3541257,-123.1738498,34980,36.1181822,-86.6441196,private,50,0,57,0,0,107,107,30,0,87,0,0,117,117,3.066075426
14460,42.517606,-71.0219925,18500,42.2667252,-77.3855253,private,0,0,53,0,0,53,53,0,0,76,0,0,76,76,3.04051795
14460,42.517606,-71.0219925,26900,39.74867,-86.2123823,private,16,0,60,0,0,76,76,13,0,101,0,0,114,114,3.064205367
12060,33.693728,-84.3999113,23620,33.6391964,-97.2103433,private,39,0,64,0,0,103,103,24,0,86,0,0,110,110,3.061711954
26420,29.7495926,-95.3536422,29460,27.9536488,-81.6935337,private,12,0,56,0,0,68,68,20,0,78,0,0,98,98,3.054231717
31080,34.1087033,-118.1827533,18140,39.9685617,-82.8359105,private,15,0,223,0,0,238,238,0,0,273,0,0,273,273,3.163318505
41860,37.7737185,-122.2744317,45940,40.2825026,-74.703724,private,0,0,48,0,0,48,48,0,0,96,0,0,96,96,3.052985011
42660,47.4905993,-121.833996,12580,39.304361,-76.5495009,private,13,0,181,0,0,194,194,11,0,181,0,0,192,192,3.112826906
37980,39.8949576,-75.3119824,41980,18.2944526,-66.0368437,private,13,0,121,0,0,134,134,0,0,77,0,0,77,77,3.041141303
33100,26.1018281,-80.4787552,34740,43.2892579,-86.751892,private,18,36,41,0,36,59,95,20,52,37,0,52,57,109,3.061088601
33100,26.1018281,-80.4787552,38900,45.6006221,-122.484378,private,19,0,152,0,0,171,171,0,0,153,0,0,153,153,3.088516136
33460,45.096664,-93.275361,11460,42.2522168,-83.8434233,private,0,0,111,0,0,111,111,15,0,126,0,0,141,141,3.081035899
19100,32.8491708,-96.9704894,29460,27.9536488,-81.6935337,private,26,0,70,0,0,96,96,21,0,71,0,0,92,92,3.050491599
26420,29.7495926,-95.3536422,34580,48.4932917,-121.8157703,private,27,0,90,0,0,117,117,14,0,62,0,0,76,76,3.04051795
14460,42.517606,-71.0219925,24020,43.4404503,-73.6367573,private,0,0,31,0,0,31,31,0,11,64,0,11,64,75,3.039894597
14460,42.517606,-71.0219925,31540,43.0842941,-89.5971796,private,0,0,61,0,0,61,61,0,0,99,0,0,99,99,3.05485507
35620,40.77493,-73.873758,24660,36.0252039,-79.7926333,private,0,0,269,0,0,269,269,23,0,424,0,0,447,447,3.27178194
47900,38.7982054,-77.4868816,38860,43.6514172,-70.4183755,private,12,12,86,0,12,98,110,11,19,126,0,19,137,156,3.090386196
33100,26.1018281,-80.4787552,10380,18.3569648,-67.0078951,private,18,0,99,0,0,117,117,16,0,104,0,0,120,120,3.067945485
33100,26.1018281,-80.4787552,35100,35.1168292,-77.0813197,private,23,0,58,0,0,81,81,30,11,80,0,11,110,121,3.068568838
33460,45.096664,-93.275361,22660,40.6580933,-105.4867638,private,51,0,129,0,0,180,180,45,0,141,0,0,186,186,3.109086788
19100,32.8491708,-96.9704894,12940,30.5187808,-91.1255901,private,21,0,115,0,0,136,136,38,0,128,0,0,166,166,3.096619726
49740,32.7739424,-113.910905,46140,36.2544287,-96.1773294,private,27,0,57,0,0,84,84,28,0,70,0,0,98,98,3.054231717
49740,32.7739424,-113.910905,28660,31.2027301,-97.7896384,private,34,0,40,0,0,74,74,28,0,47,0,0,75,75,3.039894597
31080,34.1087033,-118.1827533,24860,34.6837085,-82.4134227,private,0,0,70,0,0,70,70,24,0,116,0,0,140,140,3.080412546
31080,34.1087033,-118.1827533,17140,39.0998213,-84.4804072,private,0,0,117,0,0,117,117,0,0,226,0,0,226,226,3.134020911
31080,34.1087033,-118.1827533,36420,35.4309676,-97.5069659,private,0,0,171,0,0,171,171,12,0,227,0,0,239,239,3.142124501
31080,34.1087033,-118.1827533,39820,40.7605142,-122.0435556,private,24,0,135,0,0,159,159,45,0,233,0,0,278,278,3.16643527
41860,37.7737185,-122.2744317,12580,39.304361,-76.5495009,private,0,0,117,0,0,117,117,0,0,189,0,0,189,189,3.110956847
42660,47.4905993,-121.833996,45300,28.1259071,-82.4652858,private,45,0,289,0,0,334,334,100,11,383,0,11,483,494,3.301079534
43220,47.3541257,-123.1738498,28060,48.3146779,-114.0542951,private,29,0,42,0,0,71,71,37,0,38,0,0,75,75,3.039894597
12060,33.693728,-84.3999113,37120,31.4306536,-85.609476,private,71,0,159,0,0,230,230,44,0,170,0,0,214,214,3.126540674
19100,32.8491708,-96.9704894,21580,36.5096687,-106.6939829,private,31,32,62,0,32,93,125,13,39,62,0,39,75,114,3.064205367
26420,29.7495926,-95.3536422,40900,38.7896779,-121.0057504,private,30,0,115,0,0,145,145,15,0,103,0,0,118,118,3.066698779
31080,34.1087033,-118.1827533,32780,42.4116214,-122.6756106,private,72,0,197,0,0,269,269,33,0,258,0,0,291,291,3.17453886
12060,33.693728,-84.3999113,22660,40.6580933,-105.4867638,private,38,0,98,0,0,136,136,49,0,112,0,0,161,161,3.093502961
26420,29.7495926,-95.3536422,16700,33.0180695,-80.0075006,private,28,0,63,0,0,91,91,35,0,77,0,0,112,112,3.06295866
26420,29.7495926,-95.3536422,19820,42.7218478,-83.2008463,private,25,0,147,0,0,172,172,27,0,185,0,0,212,212,3.125293968
38060,33.1857653,-112.0678624,15980,26.5590348,-81.8919943,private,33,0,89,0,0,122,122,39,0,124,0,0,163,163,3.094749667
38060,33.1857653,-112.0678624,24860,34.6837085,-82.4134227,private,27,0,77,0,0,104,104,52,0,79,0,0,131,131,3.074802369
41860,37.7737185,-122.2744317,10540,44.4888982,-122.5372084,private,15,0,52,0,0,67,67,16,0,112,0,0,128,128,3.07293231
41860,37.7737185,-122.2744317,10740,35.1234965,-106.4583918,private,0,0,76,0,0,76,76,0,0,115,0,0,115,115,3.06482872
42660,47.4905993,-121.833996,15980,26.5590348,-81.8919943,private,28,12,53,0,12,81,93,38,14,71,0,14,109,123,3.069815544
12060,33.693728,-84.3999113,15380,43.0443711,-78.7773351,private,14,0,141,0,0,155,155,16,0,113,0,0,129,129,3.073555663
33100,26.1018281,-80.4787552,38300,40.4395249,-79.8360972,private,17,41,96,0,41,113,154,22,45,124,0,45,146,191,3.112203553
19100,32.8491708,-96.9704894,40900,38.7896779,-121.0057504,private,34,0,145,0,0,179,179,44,0,173,0,0,217,217,3.128410733
20900,29.2784805,-96.2296745,36420,35.4309676,-97.5069659,private,37,0,70,0,0,107,107,42,0,55,0,0,97,97,3.053608364
14460,42.517606,-71.0219925,18180,43.2995786,-71.6800412,private,0,0,46,0,0,46,46,14,0,59,0,0,73,73,3.038647891
14460,42.517606,-71.0219925,15380,43.0443711,-78.7773351,private,0,0,102,0,0,102,102,14,0,83,0,0,97,97,3.053608364
33100,26.1018281,-80.4787552,33460,45.096664,-93.275361,private,50,55,178,0,55,228,283,31,71,156,0,71,187,258,3.153968209
33460,45.096664,-93.275361,18140,39.9685617,-82.8359105,private,14,0,131,0,0,145,145,30,0,136,0,0,166,166,3.096619726
49740,32.7739424,-113.910905,41180,38.7402108,-90.3458253,private,51,70,93,0,70,144,214,57,55,110,0,55,167,222,3.131527498
34580,48.4932917,-121.8157703,42020,35.3852242,-120.4475445,private,12,12,40,0,12,52,64,14,12,47,0,12,61,73,3.038647891
19100,32.8491708,-96.9704894,15140,35.5866782,-89.2826913,private,25,0,69,0,0,94,94,17,0,68,0,0,85,85,3.046128127
19100,32.8491708,-96.9704894,33340,43.0176601,-87.4815541,private,49,0,125,0,0,174,174,11,0,150,0,0,161,161,3.093502961
20900,29.2784805,-96.2296745,36740,28.4343962,-81.3560839,private,21,0,101,0,0,122,122,55,0,82,0,0,137,137,3.078542487
38060,33.1857653,-112.0678624,29660,41.6655141,-105.7218826,private,25,31,50,0,31,75,106,31,16,46,0,16,77,93,3.051114952
16980,41.8235214,-87.8282967,37860,30.6554013,-87.1618275,private,51,53,145,0,53,196,249,92,37,148,0,37,240,277,3.165811917
16980,41.8235214,-87.8282967,10420,41.1466395,-81.3501104,private,18,0,113,0,0,131,131,23,0,105,0,0,128,128,3.07293231
20900,29.2784805,-96.2296745,29340,29.9787547,-93.2532434,private,16,0,52,0,0,68,68,21,0,51,0,0,72,72,3.038024537
20900,29.2784805,-96.2296745,30980,32.4316457,-94.6848326,private,24,0,34,0,0,58,58,25,0,47,0,0,72,72,3.038024537
49740,32.7739424,-113.910905,29940,38.8964168,-95.2909475,private,12,22,28,0,22,40,62,21,15,36,0,15,57,72,3.038024537
43220,47.3541257,-123.1738498,35980,41.4726517,-72.1086339,private,35,0,31,0,0,66,66,37,0,35,0,0,72,72,3.038024537
43220,47.3541257,-123.1738498,48180,31.1331137,-82.3686504,private,45,0,25,0,0,70,70,45,0,27,0,0,72,72,3.038024537
37980,39.8949576,-75.3119824,34980,36.1181822,-86.6441196,private,11,0,132,0,0,143,143,0,0,164,0,0,164,164,3.09537302
47900,38.7982054,-77.4868816,18140,39.9685617,-82.8359105,private,12,0,76,0,0,88,88,13,0,105,0,0,118,118,3.066698779
12060,33.693728,-84.3999113,25420,40.335915,-77.0504897,private,39,0,102,0,0,141,141,12,0,123,0,0,135,135,3.077295781
33100,26.1018281,-80.4787552,25980,31.7787881,-81.5764801,private,17,0,86,0,0,103,103,17,0,80,0,0,97,97,3.053608364
16980,41.8235214,-87.8282967,32580,26.3963839,-98.18099,private,37,97,124,0,97,161,258,27,97,138,0,97,165,262,3.156461621
38060,33.1857653,-112.0678624,10420,41.1466395,-81.3501104,private,17,18,80,0,18,97,115,25,14,81,0,14,106,120,3.067945485
38060,33.1857653,-112.0678624,19340,41.3916799,-90.460076,private,61,86,57,0,86,118,204,58,51,85,0,51,143,194,3.114073612
49740,32.7739424,-113.910905,39340,39.872067,-112.3590592,private,29,15,27,0,15,56,71,19,20,25,0,20,44,64,3.033037713
34580,48.4932917,-121.8157703,37100,34.3587415,-119.1331432,private,25,0,46,0,0,71,71,16,0,35,0,0,51,51,3.024934123
14460,42.517606,-71.0219925,46060,32.1280427,-111.7836574,private,12,0,71,0,0,83,83,0,12,70,0,12,70,82,3.044258068
35620,40.77493,-73.873758,23540,29.4807065,-82.6274667,private,0,0,87,0,0,87,87,18,0,97,0,0,115,115,3.06482872
35620,40.77493,-73.873758,49740,32.7739424,-113.910905,private,0,0,76,0,0,76,76,11,12,162,0,12,173,185,3.108463435
37980,39.8949576,-75.3119824,40380,43.148038,-77.5232575,private,0,0,74,0,0,74,74,0,0,110,0,0,110,110,3.061711954
33100,26.1018281,-80.4787552,41180,38.7402108,-90.3458253,private,24,26,120,0,26,144,170,31,16,132,0,16,163,179,3.104723316
16980,41.8235214,-87.8282967,13820,33.4025986,-86.7295151,private,0,0,53,0,0,53,53,14,0,89,0,0,103,103,3.057348483
19100,32.8491708,-96.9704894,34940,26.118786,-81.4009553,private,20,17,44,0,17,64,81,19,18,68,0,18,87,105,3.058595189
26420,29.7495926,-95.3536422,36540,41.2904587,-95.9999701,private,15,0,71,0,0,86,86,13,0,58,0,0,71,71,3.037401184
42660,47.4905993,-121.833996,36420,35.4309676,-97.5069659,private,13,0,107,0,0,120,120,18,0,149,0,0,167,167,3.097243079
42660,47.4905993,-121.833996,46380,39.4323876,-123.4428811,private,0,0,71,0,0,71,71,15,0,102,0,0,117,117,3.066075426
33100,26.1018281,-80.4787552,48180,31.1331137,-82.3686504,private,34,0,82,0,0,116,116,17,0,71,0,0,88,88,3.047998187
33460,45.096664,-93.275361,39580,35.7567464,-78.4604412,private,45,0,199,0,0,244,244,47,0,184,0,0,231,231,3.137137676
19100,32.8491708,-96.9704894,40060,37.4113241,-77.4418164,private,41,0,156,0,0,197,197,37,0,107,0,0,144,144,3.082905959
42660,47.4905993,-121.833996,37340,28.2983112,-80.7003334,private,22,0,79,0,0,101,101,32,0,88,0,0,120,120,3.067945485
34580,48.4932917,-121.8157703,15680,38.2202894,-76.5303837,private,28,0,42,0,0,70,70,22,0,35,0,0,57,57,3.028674241
43220,47.3541257,-123.1738498,42020,35.3852242,-120.4475445,private,16,15,39,0,15,55,70,15,16,39,0,16,54,70,3.036777831
14460,42.517606,-71.0219925,17140,39.0998213,-84.4804072,private,0,0,100,0,0,100,100,0,0,115,0,0,115,115,3.06482872
35620,40.77493,-73.873758,40900,38.7896779,-121.0057504,private,0,0,216,0,0,216,216,0,0,372,0,0,372,372,3.225030459
12060,33.693728,-84.3999113,49180,36.0788515,-80.3450642,private,0,0,142,0,0,142,142,36,0,158,0,0,194,194,3.114073612
26420,29.7495926,-95.3536422,11700,35.5956693,-82.6816145,private,13,17,25,0,17,38,55,37,23,38,0,23,75,98,3.054231717
26420,29.7495926,-95.3536422,11100,35.2478969,-101.9086384,private,27,0,101,0,0,128,128,13,0,136,0,0,149,149,3.086022724
20900,29.2784805,-96.2296745,17820,38.8455072,-104.6387277,private,15,0,29,0,0,44,44,35,0,35,0,0,70,70,3.036777831
38060,33.1857653,-112.0678624,37980,39.8949576,-75.3119824,private,69,60,309,0,60,378,438,39,41,337,0,41,376,417,3.253081348
38060,33.1857653,-112.0678624,37260,29.5938964,-81.7320389,private,14,0,97,0,0,111,111,20,0,88,0,0,108,108,3.060465248
49740,32.7739424,-113.910905,43260,44.7813692,-106.8812114,private,0,42,0,0,42,0,42,19,35,16,0,35,35,70,3.036777831
42660,47.4905993,-121.833996,17460,41.7603919,-81.7242168,private,0,0,95,0,0,95,95,0,0,141,0,0,141,141,3.081035899
33460,45.096664,-93.275361,36100,29.2028047,-82.0431004,private,20,36,62,0,36,82,118,20,37,48,0,37,68,105,3.058595189
16980,41.8235214,-87.8282967,39300,41.7068313,-71.2866369,private,14,0,117,0,0,131,131,0,0,137,0,0,137,137,3.078542487
20900,29.2784805,-96.2296745,31180,33.4703271,-101.6488249,private,26,0,43,0,0,69,69,18,0,36,0,0,54,54,3.026804182
49740,32.7739424,-113.910905,16700,33.0180695,-80.0075006,private,15,0,54,0,0,69,69,0,0,40,0,0,40,40,3.018077239
49740,32.7739424,-113.910905,33100,26.1018281,-80.4787552,private,32,0,134,0,0,166,166,14,0,131,0,0,145,145,3.083529312
42660,47.4905993,-121.833996,17980,32.4193768,-84.8437095,private,34,0,35,0,0,69,69,22,0,21,0,0,43,43,3.019947298
35620,40.77493,-73.873758,10740,35.1234965,-106.4583918,private,0,0,49,0,0,49,49,0,0,175,0,0,175,175,3.102229904
47900,38.7982054,-77.4868816,27260,30.2365943,-81.7544462,private,13,0,78,0,0,91,91,24,0,113,0,0,137,137,3.078542487
16980,41.8235214,-87.8282967,45380,39.5455242,-89.2795927,private,30,0,150,0,0,180,180,15,0,169,0,0,184,184,3.107840082
16980,41.8235214,-87.8282967,27300,39.6939496,-90.2850474,private,11,0,103,0,0,114,114,26,0,149,0,0,175,175,3.102229904
19100,32.8491708,-96.9704894,32540,34.9255401,-95.7481302,private,26,0,52,0,0,78,78,25,0,59,0,0,84,84,3.045504774
42660,47.4905993,-121.833996,42020,35.3852242,-120.4475445,private,16,0,96,0,0,112,112,17,15,118,0,15,135,150,3.086646077
12060,33.693728,-84.3999113,12940,30.5187808,-91.1255901,private,39,0,131,0,0,170,170,15,0,109,0,0,124,124,3.070438897
38060,33.1857653,-112.0678624,28660,31.2027301,-97.7896384,private,34,0,107,0,0,141,141,25,0,99,0,0,124,124,3.070438897
49740,32.7739424,-113.910905,33500,48.3202424,-101.1980099,private,18,35,15,0,35,33,68,14,30,17,0,30,31,61,3.031167654
42660,47.4905993,-121.833996,25980,31.7787881,-81.5764801,private,43,0,25,0,0,68,68,27,0,33,0,0,60,60,3.030544301
35620,40.77493,-73.873758,34580,48.4932917,-121.8157703,private,0,0,88,0,0,88,88,0,0,133,0,0,133,133,3.076049075
33100,26.1018281,-80.4787552,49740,32.7739424,-113.910905,private,0,0,85,0,0,85,85,15,0,117,0,0,132,132,3.075425722
16980,41.8235214,-87.8282967,22180,35.1559863,-78.93185,private,0,0,92,0,0,92,92,31,0,132,0,0,163,163,3.094749667
26420,29.7495926,-95.3536422,28940,36.0147907,-84.2067014,private,0,0,58,0,0,58,58,26,0,94,0,0,120,120,3.067945485
41860,37.7737185,-122.2744317,12540,35.3466288,-118.7295064,private,11,0,113,0,0,124,124,12,0,212,0,0,224,224,3.132774205
42660,47.4905993,-121.833996,23620,33.6391964,-97.2103433,private,22,0,70,0,0,92,92,28,0,61,0,0,89,89,3.04862154
42660,47.4905993,-121.833996,28140,38.9318494,-94.4438241,private,0,0,162,0,0,162,162,26,0,197,0,0,223,223,3.132150851
34580,48.4932917,-121.8157703,19740,39.434789,-104.9010728,private,32,0,124,0,0,156,156,38,0,140,0,0,178,178,3.104099963
12060,33.693728,-84.3999113,28140,38.9318494,-94.4438241,private,37,0,209,0,0,246,246,0,0,194,0,0,194,194,3.114073612
12060,33.693728,-84.3999113,22220,36.1163935,-94.0795449,private,42,0,96,0,0,138,138,49,0,47,0,0,96,96,3.052985011
16980,41.8235214,-87.8282967,35300,41.3497185,-72.9002033,private,0,0,123,0,0,123,123,0,0,107,0,0,107,107,3.059841895
42660,47.4905993,-121.833996,36740,28.4343962,-81.3560839,private,51,0,278,0,0,329,329,50,12,295,0,12,345,357,3.215680163
35620,40.77493,-73.873758,35900,36.2088833,-81.1660949,private,0,0,33,0,0,33,33,12,21,64,0,21,76,97,3.053608364
37980,39.8949576,-75.3119824,36100,29.2028047,-82.0431004,private,16,0,67,0,0,83,83,30,11,88,0,11,118,129,3.073555663
33100,26.1018281,-80.4787552,48580,42.6681095,-88.5417306,private,0,33,18,0,33,18,51,15,36,29,0,36,44,80,3.043011362
38060,33.1857653,-112.0678624,16700,33.0180695,-80.0075006,private,12,0,81,0,0,93,93,21,0,96,0,0,117,117,3.066075426
38060,33.1857653,-112.0678624,13940,43.2163568,-112.3992058,private,31,32,23,0,32,54,86,45,36,42,0,36,87,123,3.069815544
49740,32.7739424,-113.910905,27260,30.2365943,-81.7544462,private,18,0,55,0,0,73,73,32,0,69,0,0,101,101,3.056101777
41860,37.7737185,-122.2744317,16700,33.0180695,-80.0075006,private,0,0,28,0,0,28,28,0,0,85,0,0,85,85,3.046128127
42660,47.4905993,-121.833996,39900,40.5007953,-119.7311608,private,18,0,94,0,0,112,112,21,0,95,0,0,116,116,3.065452073
34580,48.4932917,-121.8157703,35840,27.3642461,-82.3193579,private,13,14,19,0,14,32,46,20,19,28,0,19,48,67,3.034907772
43220,47.3541257,-123.1738498,10740,35.1234965,-106.4583918,private,16,0,48,0,0,64,64,20,0,47,0,0,67,67,3.034907772
12060,33.693728,-84.3999113,19460,34.4893614,-87.0971469,private,37,0,129,0,0,166,166,31,0,126,0,0,157,157,3.091009549
16980,41.8235214,-87.8282967,30460,38.1028763,-84.4385451,private,13,0,133,0,0,146,146,24,0,144,0,0,168,168,3.097866432
19100,32.8491708,-96.9704894,33380,32.7321522,-93.3398245,private,13,0,94,0,0,107,107,14,0,75,0,0,89,89,3.04862154
20900,29.2784805,-96.2296745,46140,36.2544287,-96.1773294,private,53,0,58,0,0,111,111,23,0,70,0,0,93,93,3.051114952
20900,29.2784805,-96.2296745,29820,36.2142575,-115.013812,private,20,0,46,0,0,66,66,16,0,42,0,0,58,58,3.029297594
38060,33.1857653,-112.0678624,35300,41.3497185,-72.9002033,private,15,22,46,0,22,61,83,0,22,49,0,22,49,71,3.037401184
14460,42.517606,-71.0219925,16820,37.9490837,-78.5932062,private,0,0,54,0,0,54,54,0,0,66,0,0,66,66,3.034284419
35620,40.77493,-73.873758,46540,43.3322796,-75.1731893,private,0,0,155,0,0,155,155,0,33,286,0,33,286,319,3.191992746
37980,39.8949576,-75.3119824,14860,41.2274128,-73.3670614,private,0,0,108,0,0,108,108,0,0,158,0,0,158,158,3.091632902
37980,39.8949576,-75.3119824,15380,43.0443711,-78.7773351,private,0,0,51,0,0,51,51,23,0,91,0,0,114,114,3.064205367
47900,38.7982054,-77.4868816,48900,34.4260331,-77.889634,private,0,0,21,0,0,21,21,0,0,66,0,0,66,66,3.034284419
47900,38.7982054,-77.4868816,46060,32.1280427,-111.7836574,private,11,0,47,0,0,58,58,11,0,55,0,0,66,66,3.034284419
33100,26.1018281,-80.4787552,40380,43.148038,-77.5232575,private,0,64,88,0,64,88,152,27,54,107,0,54,134,188,3.110333494
16980,41.8235214,-87.8282967,48900,34.4260331,-77.889634,private,25,0,80,0,0,105,105,53,11,110,0,11,163,174,3.101606551
19100,32.8491708,-96.9704894,37980,39.8949576,-75.3119824,private,92,0,300,0,0,392,392,24,0,242,0,0,266,266,3.158955034
26420,29.7495926,-95.3536422,37340,28.2983112,-80.7003334,private,27,0,64,0,0,91,91,19,0,67,0,0,86,86,3.04675148
38060,33.1857653,-112.0678624,37340,28.2983112,-80.7003334,private,36,0,55,0,0,91,91,29,0,102,0,0,131,131,3.074802369
38060,33.1857653,-112.0678624,24300,39.019524,-108.4605707,private,26,26,71,0,26,97,123,52,0,87,0,0,139,139,3.079789193
43220,47.3541257,-123.1738498,33700,37.5623162,-121.0028311,private,0,0,31,0,0,31,31,13,0,53,0,0,66,66,3.034284419
12060,33.693728,-84.3999113,46060,32.1280427,-111.7836574,private,39,0,128,0,0,167,167,0,0,121,0,0,121,121,3.068568838
33460,45.096664,-93.275361,41180,38.7402108,-90.3458253,private,16,0,212,0,0,228,228,0,0,181,0,0,181,181,3.105970022
33460,45.096664,-93.275361,41620,40.5728869,-112.9532527,private,0,0,106,0,0,106,106,0,0,72,0,0,72,72,3.038024537
19100,32.8491708,-96.9704894,29180,29.9577733,-92.0493498,private,22,0,104,0,0,126,126,0,0,117,0,0,117,117,3.066075426
49740,32.7739424,-113.910905,45300,28.1259071,-82.4652858,private,39,0,142,0,0,181,181,69,0,153,0,0,222,222,3.131527498
35620,40.77493,-73.873758,17900,34.0775845,-81.0378453,private,0,0,250,0,0,250,250,45,0,304,0,0,349,349,3.210693339
33460,45.096664,-93.275361,28140,38.9318494,-94.4438241,private,18,0,210,0,0,228,228,13,0,183,0,0,196,196,3.115320318
16980,41.8235214,-87.8282967,15380,43.0443711,-78.7773351,private,0,0,64,0,0,64,64,0,0,106,0,0,106,106,3.059218542
19100,32.8491708,-96.9704894,25060,30.4801526,-88.9992972,private,0,0,55,0,0,55,55,25,0,54,0,0,79,79,3.042388009
26420,29.7495926,-95.3536422,46060,32.1280427,-111.7836574,private,0,0,101,0,0,101,101,13,0,102,0,0,115,115,3.06482872
49740,32.7739424,-113.910905,36740,28.4343962,-81.3560839,private,30,0,94,0,0,124,124,35,0,107,0,0,142,142,3.081659253
49740,32.7739424,-113.910905,44180,37.3608699,-93.1802617,private,52,38,63,0,38,115,153,45,19,94,0,19,139,158,3.091632902
42660,47.4905993,-121.833996,27260,30.2365943,-81.7544462,private,39,0,149,0,0,188,188,37,0,200,0,0,237,237,3.140877794
33100,26.1018281,-80.4787552,42340,32.1091533,-81.2731066,private,14,0,86,0,0,100,100,32,0,78,0,0,110,110,3.061711954
19100,32.8491708,-96.9704894,41660,31.4798393,-100.7745902,private,20,0,91,0,0,111,111,28,0,72,0,0,100,100,3.055478423
34580,48.4932917,-121.8157703,16700,33.0180695,-80.0075006,private,24,0,40,0,0,64,64,26,0,30,0,0,56,56,3.028050888
14460,42.517606,-71.0219925,48900,34.4260331,-77.889634,private,12,0,32,0,0,44,44,14,0,50,0,0,64,64,3.033037713
37980,39.8949576,-75.3119824,20900,29.2784805,-96.2296745,private,0,0,54,0,0,54,54,16,0,68,0,0,84,84,3.045504774
33100,26.1018281,-80.4787552,38860,43.6514172,-70.4183755,private,0,39,33,0,39,33,72,0,38,37,0,38,37,75,3.039894597
33460,45.096664,-93.275361,39660,44.3154852,-102.7683833,private,18,0,80,0,0,98,98,37,0,96,0,0,133,133,3.076049075
33460,45.096664,-93.275361,26900,39.74867,-86.2123823,private,0,0,139,0,0,139,139,27,0,128,0,0,155,155,3.089762842
33460,45.096664,-93.275361,41940,36.9084718,-121.3713721,private,0,0,202,0,0,202,202,11,0,158,0,0,169,169,3.098489786
19100,32.8491708,-96.9704894,24860,34.6837085,-82.4134227,private,20,0,67,0,0,87,87,17,0,79,0,0,96,96,3.052985011
19100,32.8491708,-96.9704894,31140,38.3058381,-85.6816455,private,16,0,102,0,0,118,118,12,0,77,0,0,89,89,3.04862154
38060,33.1857653,-112.0678624,22220,36.1163935,-94.0795449,private,18,0,94,0,0,112,112,50,0,78,0,0,128,128,3.07293231
38060,33.1857653,-112.0678624,46380,39.4323876,-123.4428811,private,0,11,89,0,11,89,100,14,18,74,0,18,88,106,3.059218542
31080,34.1087033,-118.1827533,39300,41.7068313,-71.2866369,private,0,0,136,0,0,136,136,0,0,202,0,0,202,202,3.119060437
43220,47.3541257,-123.1738498,19740,39.434789,-104.9010728,private,29,0,137,0,0,166,166,47,0,94,0,0,141,141,3.081035899
38060,33.1857653,-112.0678624,38300,40.4395249,-79.8360972,private,11,35,160,0,35,171,206,31,0,159,0,0,190,190,3.1115802
49740,32.7739424,-113.910905,22220,36.1163935,-94.0795449,private,17,0,46,0,0,63,63,28,0,34,0,0,62,62,3.031791007
34580,48.4932917,-121.8157703,22660,40.6580933,-105.4867638,private,17,0,46,0,0,63,63,13,0,49,0,0,62,62,3.031791007
47900,38.7982054,-77.4868816,22180,35.1559863,-78.93185,private,0,0,51,0,0,51,51,11,0,52,0,0,63,63,3.03241436
26420,29.7495926,-95.3536422,26380,29.3341299,-90.8436739,private,12,0,47,0,0,59,59,16,0,72,0,0,88,88,3.047998187
26420,29.7495926,-95.3536422,40140,34.5384763,-116.1345414,private,15,0,181,0,0,196,196,13,0,196,0,0,209,209,3.123423908
49740,32.7739424,-113.910905,15980,26.5590348,-81.8919943,private,17,0,42,0,0,59,59,20,0,43,0,0,63,63,3.03241436
31080,34.1087033,-118.1827533,40060,37.4113241,-77.4418164,private,0,0,83,0,0,83,83,0,0,115,0,0,115,115,3.06482872
31080,34.1087033,-118.1827533,46140,36.2544287,-96.1773294,private,0,0,115,0,0,115,115,11,0,189,0,0,200,200,3.117813731
41860,37.7737185,-122.2744317,21580,36.5096687,-106.6939829,private,0,0,66,0,0,66,66,0,0,97,0,0,97,97,3.053608364
35620,40.77493,-73.873758,49620,39.9217514,-76.7288887,private,0,0,100,0,0,100,100,26,0,135,0,0,161,161,3.093502961
47900,38.7982054,-77.4868816,29820,36.2142575,-115.013812,private,0,0,62,0,0,62,62,0,0,53,0,0,53,53,3.026180829
16980,41.8235214,-87.8282967,37940,40.7728833,-86.0442575,private,32,0,83,0,0,115,115,18,0,103,0,0,121,121,3.068568838
49740,32.7739424,-113.910905,40420,42.331183,-89.0429139,private,13,28,21,0,28,34,62,18,20,22,0,20,40,60,3.030544301
49740,32.7739424,-113.910905,20900,29.2784805,-96.2296745,private,17,0,45,0,0,62,62,29,0,33,0,0,62,62,3.031791007
14460,42.517606,-71.0219925,10580,42.7879202,-73.9423479,private,0,0,98,0,0,98,98,0,0,146,0,0,146,146,3.084152665
47900,38.7982054,-77.4868816,14500,40.0949699,-105.3976911,private,0,0,45,0,0,45,45,0,0,62,0,0,62,62,3.031791007
12060,33.693728,-84.3999113,40140,34.5384763,-116.1345414,private,50,0,258,0,0,308,308,23,0,293,0,0,316,316,3.190122687
20900,29.2784805,-96.2296745,45300,28.1259071,-82.4652858,private,14,0,62,0,0,76,76,25,0,109,0,0,134,134,3.076672428
38060,33.1857653,-112.0678624,27420,46.9722235,-98.9561228,private,22,52,13,0,52,35,87,34,49,30,0,49,64,113,3.063582013
38060,33.1857653,-112.0678624,40420,42.331183,-89.0429139,private,0,23,35,0,23,35,58,16,18,45,0,18,61,79,3.042388009
49740,32.7739424,-113.910905,23620,33.6391964,-97.2103433,private,25,0,33,0,0,58,58,27,0,35,0,0,62,62,3.031791007
31080,34.1087033,-118.1827533,33340,43.0176601,-87.4815541,private,0,0,97,0,0,97,97,0,0,133,0,0,133,133,3.076049075
42660,47.4905993,-121.833996,37860,30.6554013,-87.1618275,private,34,0,81,0,0,115,115,28,11,103,0,11,131,142,3.081659253
34580,48.4932917,-121.8157703,10740,35.1234965,-106.4583918,private,13,0,43,0,0,56,56,28,0,67,0,0,95,95,3.052361658
43220,47.3541257,-123.1738498,37340,28.2983112,-80.7003334,private,22,12,18,0,12,40,52,21,0,41,0,0,62,62,3.031791007
43220,47.3541257,-123.1738498,39820,40.7605142,-122.0435556,private,0,0,38,0,0,38,38,27,0,35,0,0,62,62,3.031791007
33460,45.096664,-93.275361,34980,36.1181822,-86.6441196,private,50,0,205,0,0,255,255,68,0,205,0,0,273,273,3.163318505
34580,48.4932917,-121.8157703,12060,33.693728,-84.3999113,private,42,0,80,0,0,122,122,0,0,69,0,0,69,69,3.036154478
14460,42.517606,-71.0219925,13620,44.6525477,-71.2894309,private,0,0,18,0,0,18,18,11,24,26,0,24,37,61,3.031167654
14460,42.517606,-71.0219925,19820,42.7218478,-83.2008463,private,11,0,102,0,0,113,113,0,0,132,0,0,132,132,3.075425722
35620,40.77493,-73.873758,17820,38.8455072,-104.6387277,private,0,0,92,0,0,92,92,12,0,121,0,0,133,133,3.076049075
47900,38.7982054,-77.4868816,40900,38.7896779,-121.0057504,private,0,0,95,0,0,95,95,0,0,108,0,0,108,108,3.060465248
33100,26.1018281,-80.4787552,24660,36.0252039,-79.7926333,private,42,0,141,0,0,183,183,29,0,190,0,0,219,219,3.129657439
26420,29.7495926,-95.3536422,35060,31.7325509,-93.0826114,private,31,0,60,0,0,91,91,36,0,78,0,0,114,114,3.064205367
31080,34.1087033,-118.1827533,14500,40.0949699,-105.3976911,private,12,0,59,0,0,71,71,14,0,109,0,0,123,123,3.069815544
34580,48.4932917,-121.8157703,17820,38.8455072,-104.6387277,private,12,0,30,0,0,42,42,18,0,43,0,0,61,61,3.031167654
16980,41.8235214,-87.8282967,16860,35.0493612,-85.3611582,private,79,0,148,0,0,227,227,73,0,196,0,0,269,269,3.160825093
38060,33.1857653,-112.0678624,22180,35.1559863,-78.93185,private,11,0,80,0,0,91,91,15,0,70,0,0,85,85,3.046128127
38060,33.1857653,-112.0678624,16580,40.1029885,-88.3185039,private,11,14,50,0,14,61,75,0,13,39,0,13,39,52,3.025557476
38060,33.1857653,-112.0678624,46140,36.2544287,-96.1773294,private,19,0,103,0,0,122,122,63,0,135,0,0,198,198,3.116567025
42660,47.4905993,-121.833996,20500,36.0605886,-78.9897875,private,0,0,76,0,0,76,76,11,0,60,0,0,71,71,3.037401184
35620,40.77493,-73.873758,46380,39.4323876,-123.4428811,private,0,0,56,0,0,56,56,0,0,119,0,0,119,119,3.067322132
37980,39.8949576,-75.3119824,44300,40.9091275,-77.8478769,private,0,0,78,0,0,78,78,0,0,104,0,0,104,104,3.057971836
47900,38.7982054,-77.4868816,26900,39.74867,-86.2123823,private,0,0,61,0,0,61,61,0,0,79,0,0,79,79,3.042388009
47900,38.7982054,-77.4868816,21580,36.5096687,-106.6939829,private,0,0,21,0,0,21,21,11,11,38,0,11,49,60,3.030544301
33100,26.1018281,-80.4787552,45060,43.0065163,-76.1961336,private,0,20,51,0,20,51,71,14,17,76,0,17,90,107,3.059841895
33460,45.096664,-93.275361,37980,39.8949576,-75.3119824,private,0,0,197,0,0,197,197,0,0,178,0,0,178,178,3.104099963
16980,41.8235214,-87.8282967,26340,47.6819737,-88.1487965,private,0,21,46,0,21,46,67,23,38,78,0,38,101,139,3.079789193
20900,29.2784805,-96.2296745,49740,32.7739424,-113.910905,private,20,0,16,0,0,36,36,15,0,45,0,0,60,60,3.030544301
42660,47.4905993,-121.833996,21580,36.5096687,-106.6939829,private,0,0,46,0,0,46,46,0,0,76,0,0,76,76,3.04051795
35620,40.77493,-73.873758,10380,18.3569648,-67.0078951,private,15,0,106,0,0,121,121,0,0,126,0,0,126,126,3.071685603
12060,33.693728,-84.3999113,21340,31.527394,-105.5213326,private,15,0,100,0,0,115,115,0,0,71,0,0,71,71,3.037401184
33100,26.1018281,-80.4787552,49340,42.2173112,-71.9255354,private,18,39,74,0,39,92,131,18,11,55,0,11,73,84,3.045504774
33100,26.1018281,-80.4787552,31700,42.9115317,-71.7230554,private,15,23,47,0,23,62,85,12,18,34,0,18,46,64,3.033037713
33100,26.1018281,-80.4787552,17140,39.0998213,-84.4804072,private,14,26,116,0,26,130,156,16,17,123,0,17,139,156,3.090386196
19100,32.8491708,-96.9704894,11700,35.5956693,-82.6816145,private,36,0,59,0,0,95,95,18,0,70,0,0,88,88,3.047998187
19100,32.8491708,-96.9704894,37100,34.3587415,-119.1331432,private,13,0,66,0,0,79,79,11,0,52,0,0,63,63,3.03241436
20900,29.2784805,-96.2296745,31080,34.1087033,-118.1827533,private,59,0,163,0,0,222,222,18,0,192,0,0,210,210,3.124047261
14460,42.517606,-71.0219925,24860,34.6837085,-82.4134227,private,0,0,45,0,0,45,45,17,0,42,0,0,59,59,3.029920947
33100,26.1018281,-80.4787552,40060,37.4113241,-77.4418164,private,0,12,165,0,12,165,177,56,12,177,0,12,233,245,3.145864619
19100,32.8491708,-96.9704894,13140,30.0759278,-94.2027049,private,0,0,136,0,0,136,136,14,0,140,0,0,154,154,3.089139489
26420,29.7495926,-95.3536422,33660,30.9715095,-88.20787,private,31,0,108,0,0,139,139,68,0,112,0,0,180,180,3.105346669
26420,29.7495926,-95.3536422,25620,31.2737661,-89.3006335,private,13,0,55,0,0,68,68,28,0,70,0,0,98,98,3.054231717
38060,33.1857653,-112.0678624,47980,44.8524086,-97.1770994,private,37,45,11,0,45,48,93,39,46,29,0,46,68,114,3.064205367
41860,37.7737185,-122.2744317,17140,39.0998213,-84.4804072,private,0,0,73,0,0,73,73,0,0,112,0,0,112,112,3.06295866
12060,33.693728,-84.3999113,46220,33.0978758,-87.7991533,private,18,0,115,0,0,133,133,12,0,120,0,0,132,132,3.075425722
12060,33.693728,-84.3999113,34580,48.4932917,-121.8157703,private,29,0,73,0,0,102,102,0,0,66,0,0,66,66,3.034284419
33100,26.1018281,-80.4787552,33340,43.0176601,-87.4815541,private,14,37,73,0,37,87,124,0,27,79,0,27,79,106,3.059218542
16980,41.8235214,-87.8282967,18260,36.2772512,-85.4685013,private,89,0,99,0,0,188,188,89,0,99,0,0,188,188,3.110333494
20900,29.2784805,-96.2296745,47900,38.7982054,-77.4868816,private,33,0,114,0,0,147,147,25,0,128,0,0,153,153,3.088516136
20900,29.2784805,-96.2296745,21340,31.527394,-105.5213326,private,20,0,38,0,0,58,58,18,0,35,0,0,53,53,3.026180829
38060,33.1857653,-112.0678624,10300,41.8960225,-84.0743563,private,26,25,44,0,25,70,95,0,18,29,0,18,29,47,3.022440711
42660,47.4905993,-121.833996,35380,29.805532,-89.7013821,private,14,0,81,0,0,95,95,0,0,110,0,0,110,110,3.061711954
14460,42.517606,-71.0219925,35380,29.805532,-89.7013821,private,0,0,68,0,0,68,68,0,0,58,0,0,58,58,3.029297594
37980,39.8949576,-75.3119824,24660,36.0252039,-79.7926333,private,0,0,90,0,0,90,90,13,0,136,0,0,149,149,3.086022724
37980,39.8949576,-75.3119824,17140,39.0998213,-84.4804072,private,0,0,53,0,0,53,53,0,0,71,0,0,71,71,3.037401184
47900,38.7982054,-77.4868816,11700,35.5956693,-82.6816145,private,0,0,51,0,0,51,51,0,11,80,0,11,80,91,3.049868246
47900,38.7982054,-77.4868816,41940,36.9084718,-121.3713721,private,0,0,100,0,0,100,100,0,0,130,0,0,130,130,3.074179016
33460,45.096664,-93.275361,27260,30.2365943,-81.7544462,private,51,38,142,0,38,193,231,62,29,147,0,29,209,238,3.141501148
19100,32.8491708,-96.9704894,36380,27.3855924,-80.8873884,private,15,0,51,0,0,66,66,20,0,54,0,0,74,74,3.039271244
49740,32.7739424,-113.910905,35840,27.3642461,-82.3193579,private,19,0,30,0,0,49,49,20,0,38,0,0,58,58,3.029297594
31080,34.1087033,-118.1827533,15980,26.5590348,-81.8919943,private,0,0,88,0,0,88,88,12,0,123,0,0,135,135,3.077295781
41860,37.7737185,-122.2744317,35380,29.805532,-89.7013821,private,0,0,69,0,0,69,69,0,0,81,0,0,81,81,3.043634715
12060,33.693728,-84.3999113,30460,38.1028763,-84.4385451,private,24,0,99,0,0,123,123,11,0,105,0,0,116,116,3.065452073
12060,33.693728,-84.3999113,40900,38.7896779,-121.0057504,private,11,0,206,0,0,217,217,0,0,174,0,0,174,174,3.101606551
33100,26.1018281,-80.4787552,45940,40.2825026,-74.703724,private,27,19,62,0,19,89,108,14,16,52,0,16,66,82,3.044258068
19100,32.8491708,-96.9704894,38300,40.4395249,-79.8360972,private,27,0,102,0,0,129,129,11,0,58,0,0,69,69,3.036154478
19100,32.8491708,-96.9704894,47260,36.8044077,-76.4495261,private,13,0,101,0,0,114,114,19,0,78,0,0,97,97,3.053608364
26420,29.7495926,-95.3536422,48620,37.637896,-97.2462875,private,11,0,59,0,0,70,70,0,0,51,0,0,51,51,3.024934123
20900,29.2784805,-96.2296745,25720,40.6913977,-111.0527658,private,39,0,18,0,0,57,57,33,0,18,0,0,51,51,3.024934123
31080,34.1087033,-118.1827533,23620,33.6391964,-97.2103433,private,58,0,147,0,0,205,205,43,0,183,0,0,226,226,3.134020911
43220,47.3541257,-123.1738498,21340,31.527394,-105.5213326,private,26,0,31,0,0,57,57,21,0,32,0,0,53,53,3.026180829
37980,39.8949576,-75.3119824,24860,34.6837085,-82.4134227,private,11,0,53,0,0,64,64,30,0,72,0,0,102,102,3.05672513
47900,38.7982054,-77.4868816,45940,40.2825026,-74.703724,private,0,0,35,0,0,35,35,0,0,73,0,0,73,73,3.038647891
47900,38.7982054,-77.4868816,36740,28.4343962,-81.3560839,private,0,0,98,0,0,98,98,11,0,141,0,0,152,152,3.087892783
33100,26.1018281,-80.4787552,13820,33.4025986,-86.7295151,private,0,0,54,0,0,54,54,23,0,79,0,0,102,102,3.05672513
34580,48.4932917,-121.8157703,20900,29.2784805,-96.2296745,private,0,0,14,0,0,14,14,23,0,34,0,0,57,57,3.028674241
34580,48.4932917,-121.8157703,33700,37.5623162,-121.0028311,private,17,0,33,0,0,50,50,13,0,44,0,0,57,57,3.028674241
43220,47.3541257,-123.1738498,37260,29.5938964,-81.7320389,private,13,11,12,0,11,25,36,15,15,27,0,15,42,57,3.028674241
33100,26.1018281,-80.4787552,16860,35.0493612,-85.3611582,private,17,0,151,0,0,168,168,17,0,128,0,0,145,145,3.083529312
33460,45.096664,-93.275361,24580,44.4740244,-87.9961303,private,14,0,196,0,0,210,210,12,0,168,0,0,180,180,3.105346669
26420,29.7495926,-95.3536422,30780,34.7557726,-92.4005889,private,26,0,149,0,0,175,175,11,0,137,0,0,148,148,3.085399371
38060,33.1857653,-112.0678624,12700,41.7990145,-70.2118803,private,0,88,0,0,88,0,88,0,74,0,0,74,0,74,3.039271244
38060,33.1857653,-112.0678624,25540,41.7186503,-72.5739191,private,13,13,63,0,13,76,89,0,11,56,0,11,56,67,3.034907772
49740,32.7739424,-113.910905,37260,29.5938964,-81.7320389,private,22,0,34,0,0,56,56,14,0,32,0,0,46,46,3.021817358
49740,32.7739424,-113.910905,10300,41.8960225,-84.0743563,private,16,25,15,0,25,31,56,15,24,13,0,24,28,52,3.025557476
14460,42.517606,-71.0219925,11220,42.9008912,-74.4353575,private,0,0,42,0,0,42,42,0,0,56,0,0,56,56,3.028050888
35620,40.77493,-73.873758,29540,40.0419921,-76.250198,private,11,0,146,0,0,157,157,0,0,218,0,0,218,218,3.129034086
35620,40.77493,-73.873758,31540,43.0842941,-89.5971796,private,0,0,97,0,0,97,97,0,0,182,0,0,182,182,3.106593375
47900,38.7982054,-77.4868816,19820,42.7218478,-83.2008463,private,0,0,78,0,0,78,78,0,0,154,0,0,154,154,3.089139489
12060,33.693728,-84.3999113,27140,32.4282801,-90.2023875,private,0,0,205,0,0,205,205,15,0,184,0,0,199,199,3.117190378
33100,26.1018281,-80.4787552,24020,43.4404503,-73.6367573,private,11,31,13,0,31,24,55,0,31,25,0,31,25,56,3.028050888
33100,26.1018281,-80.4787552,23620,33.6391964,-97.2103433,private,11,0,69,0,0,80,80,34,0,56,0,0,90,90,3.049244893
38060,33.1857653,-112.0678624,15380,43.0443711,-78.7773351,private,0,44,103,0,44,103,147,13,27,77,0,27,90,117,3.066075426
31080,34.1087033,-118.1827533,28660,31.2027301,-97.7896384,private,38,0,116,0,0,154,154,29,0,160,0,0,189,189,3.110956847
41860,37.7737185,-122.2744317,16740,35.1663423,-80.7972848,private,0,0,68,0,0,68,68,15,0,167,0,0,182,182,3.106593375
42660,47.4905993,-121.833996,37260,29.5938964,-81.7320389,private,13,0,65,0,0,78,78,33,0,67,0,0,100,100,3.055478423
34580,48.4932917,-121.8157703,37340,28.2983112,-80.7003334,private,12,0,13,0,0,25,25,21,0,35,0,0,56,56,3.028050888
16980,41.8235214,-87.8282967,21580,36.5096687,-106.6939829,private,18,0,55,0,0,73,73,0,0,50,0,0,50,50,3.02431077
19100,32.8491708,-96.9704894,25540,41.7186503,-72.5739191,private,25,0,57,0,0,82,82,12,0,44,0,0,56,56,3.028050888
19100,32.8491708,-96.9704894,13820,33.4025986,-86.7295151,private,14,0,117,0,0,131,131,28,0,121,0,0,149,149,3.086022724
19100,32.8491708,-96.9704894,17460,41.7603919,-81.7242168,private,27,0,126,0,0,153,153,13,0,115,0,0,128,128,3.07293231
49740,32.7739424,-113.910905,12540,35.3466288,-118.7295064,private,25,0,82,0,0,107,107,11,0,57,0,0,68,68,3.035531125
14460,42.517606,-71.0219925,40900,38.7896779,-121.0057504,private,0,0,93,0,0,93,93,0,0,118,0,0,118,118,3.066698779
37980,39.8949576,-75.3119824,25940,32.3867916,-80.8308775,private,18,15,40,0,15,58,73,13,24,30,0,24,43,67,3.034907772
47900,38.7982054,-77.4868816,10740,35.1234965,-106.4583918,private,13,0,33,0,0,46,46,13,0,42,0,0,55,55,3.027427535
33100,26.1018281,-80.4787552,34580,48.4932917,-121.8157703,private,12,12,56,0,12,68,80,14,0,67,0,0,81,81,3.043634715
19100,32.8491708,-96.9704894,33660,30.9715095,-88.20787,private,16,0,75,0,0,91,91,26,0,85,0,0,111,111,3.062335307
38060,33.1857653,-112.0678624,45000,40.7210862,-120.6299518,private,0,53,13,0,53,13,66,0,50,18,0,50,18,68,3.035531125
49740,32.7739424,-113.910905,23940,44.2321004,-105.0343417,private,0,35,11,0,35,11,46,12,28,15,0,28,27,55,3.027427535
41860,37.7737185,-122.2744317,35840,27.3642461,-82.3193579,private,0,0,47,0,0,47,47,26,0,81,0,0,107,107,3.059841895
14460,42.517606,-71.0219925,22660,40.6580933,-105.4867638,private,0,0,54,0,0,54,54,0,0,48,0,0,48,48,3.023064064
37980,39.8949576,-75.3119824,16820,37.9490837,-78.5932062,private,0,0,73,0,0,73,73,0,0,50,0,0,50,50,3.02431077
19100,32.8491708,-96.9704894,17140,39.0998213,-84.4804072,private,33,0,132,0,0,165,165,31,0,154,0,0,185,185,3.108463435
26420,29.7495926,-95.3536422,20500,36.0605886,-78.9897875,private,0,0,66,0,0,66,66,13,0,40,0,0,53,53,3.026180829
20900,29.2784805,-96.2296745,35380,29.805532,-89.7013821,private,33,0,96,0,0,129,129,38,0,86,0,0,124,124,3.070438897
14460,42.517606,-71.0219925,45860,41.7918833,-73.2354042,private,0,0,41,0,0,41,41,0,0,54,0,0,54,54,3.026804182
47900,38.7982054,-77.4868816,17140,39.0998213,-84.4804072,private,0,0,63,0,0,63,63,0,0,83,0,0,83,83,3.044881421
47900,38.7982054,-77.4868816,33340,43.0176601,-87.4815541,private,0,0,55,0,0,55,55,0,0,74,0,0,74,74,3.039271244
26420,29.7495926,-95.3536422,13820,33.4025986,-86.7295151,private,0,0,76,0,0,76,76,12,0,90,0,0,102,102,3.05672513
31080,34.1087033,-118.1827533,45000,40.7210862,-120.6299518,private,0,13,80,0,13,80,93,0,33,100,0,33,100,133,3.076049075
41860,37.7737185,-122.2744317,36740,28.4343962,-81.3560839,private,0,0,69,0,0,69,69,14,0,193,0,0,207,207,3.122177202
41860,37.7737185,-122.2744317,45300,28.1259071,-82.4652858,private,0,0,109,0,0,109,109,0,0,215,0,0,215,215,3.127164027
34580,48.4932917,-121.8157703,39820,40.7605142,-122.0435556,private,0,0,27,0,0,27,27,15,0,39,0,0,54,54,3.026804182
14460,42.517606,-71.0219925,12620,45.4092843,-68.666616,private,0,0,36,17,17,36,53,0,0,44,0,0,44,44,3.020570651
37980,39.8949576,-75.3119824,41180,38.7402108,-90.3458253,private,0,0,66,0,0,66,66,0,0,64,0,0,64,64,3.033037713
12060,33.693728,-84.3999113,40380,43.148038,-77.5232575,private,15,0,122,0,0,137,137,0,0,110,0,0,110,110,3.061711954
12060,33.693728,-84.3999113,36540,41.2904587,-95.9999701,private,13,0,87,0,0,100,100,17,0,59,0,0,76,76,3.04051795
33100,26.1018281,-80.4787552,10580,42.7879202,-73.9423479,private,13,36,71,0,36,84,120,0,19,48,0,19,48,67,3.034907772
33460,45.096664,-93.275361,38300,40.4395249,-79.8360972,private,0,0,66,0,0,66,66,0,0,46,0,0,46,46,3.021817358
16980,41.8235214,-87.8282967,46520,21.5800225,-158.1234063,private,0,0,75,0,0,75,75,0,0,56,0,0,56,56,3.028050888
19100,32.8491708,-96.9704894,22180,35.1559863,-78.93185,private,18,0,67,0,0,85,85,20,0,57,0,0,77,77,3.041141303
49740,32.7739424,-113.910905,47900,38.7982054,-77.4868816,private,61,0,129,0,0,190,190,49,0,152,0,0,201,201,3.118437084
42660,47.4905993,-121.833996,26900,39.74867,-86.2123823,private,39,0,154,0,0,193,193,47,0,139,0,0,186,186,3.109086788
12060,33.693728,-84.3999113,32580,26.3963839,-98.18099,private,0,0,16,0,0,16,16,13,0,51,0,0,64,64,3.033037713
33100,26.1018281,-80.4787552,28660,31.2027301,-97.7896384,private,15,0,70,0,0,85,85,0,0,96,0,0,96,96,3.052985011
33460,45.096664,-93.275361,10740,35.1234965,-106.4583918,private,0,0,72,0,0,72,72,11,0,80,0,0,91,91,3.049868246
16980,41.8235214,-87.8282967,25540,41.7186503,-72.5739191,private,0,0,100,0,0,100,100,0,0,101,0,0,101,101,3.056101777
16980,41.8235214,-87.8282967,43220,47.3541257,-123.1738498,private,29,0,124,0,0,153,153,16,0,118,0,0,134,134,3.076672428
19100,32.8491708,-96.9704894,14260,43.0066485,-116.1419089,private,37,0,52,0,0,89,89,33,0,69,0,0,102,102,3.05672513
20900,29.2784805,-96.2296745,47380,31.4272264,-97.0934727,private,35,0,59,0,0,94,94,33,0,65,0,0,98,98,3.054231717
31080,34.1087033,-118.1827533,31140,38.3058381,-85.6816455,private,0,0,79,0,0,79,79,0,0,85,0,0,85,85,3.046128127
43220,47.3541257,-123.1738498,16980,41.8235214,-87.8282967,private,12,0,90,0,0,102,102,19,0,77,0,0,96,96,3.052985011
12060,33.693728,-84.3999113,25540,41.7186503,-72.5739191,private,13,0,144,0,0,157,157,0,0,164,0,0,164,164,3.09537302
33100,26.1018281,-80.4787552,32580,26.3963839,-98.18099,private,13,0,62,0,0,75,75,0,0,51,0,0,51,51,3.024934123
26420,29.7495926,-95.3536422,43220,47.3541257,-123.1738498,private,16,0,54,0,0,70,70,15,0,56,0,0,71,71,3.037401184
49740,32.7739424,-113.910905,31460,37.2098213,-119.7498023,private,0,15,37,0,15,37,52,0,16,32,0,16,32,48,3.023064064
41860,37.7737185,-122.2744317,10140,47.1137324,-123.8267349,private,15,0,60,0,0,75,75,16,0,79,0,0,95,95,3.052361658
14460,42.517606,-71.0219925,49740,32.7739424,-113.910905,private,0,0,35,0,0,35,35,11,0,41,0,0,52,52,3.025557476
47900,38.7982054,-77.4868816,40220,37.2862262,-79.9469346,private,0,0,32,0,0,32,32,0,0,52,0,0,52,52,3.025557476
12060,33.693728,-84.3999113,25620,31.2737661,-89.3006335,private,0,0,67,0,0,67,67,33,0,84,0,0,117,117,3.066075426
33100,26.1018281,-80.4787552,12020,33.943984,-83.2138965,private,23,0,52,0,0,75,75,19,0,55,0,0,74,74,3.039271244
33100,26.1018281,-80.4787552,27740,36.2658223,-82.3326926,private,15,0,12,0,0,27,27,13,0,54,0,0,67,67,3.034907772
16980,41.8235214,-87.8282967,16820,37.9490837,-78.5932062,private,0,0,28,0,0,28,28,0,0,52,0,0,52,52,3.025557476
16980,41.8235214,-87.8282967,34580,48.4932917,-121.8157703,private,16,0,132,0,0,148,148,22,0,133,0,0,155,155,3.089762842
19100,32.8491708,-96.9704894,27140,32.4282801,-90.2023875,private,23,0,122,0,0,145,145,46,0,182,0,0,228,228,3.135267617
26420,29.7495926,-95.3536422,16820,37.9490837,-78.5932062,private,11,0,25,0,0,36,36,12,0,40,0,0,52,52,3.025557476
26420,29.7495926,-95.3536422,10180,32.4520222,-99.7187428,private,0,0,55,0,0,55,55,13,0,55,0,0,68,68,3.035531125
20900,29.2784805,-96.2296745,22660,40.6580933,-105.4867638,private,17,0,22,0,0,39,39,26,0,26,0,0,52,52,3.025557476
20900,29.2784805,-96.2296745,41740,33.0236041,-116.7761174,private,27,11,54,0,11,81,92,26,0,69,0,0,95,95,3.052361658
38060,33.1857653,-112.0678624,34940,26.118786,-81.4009553,private,14,0,40,0,0,54,54,21,0,52,0,0,73,73,3.038647891
38060,33.1857653,-112.0678624,31140,38.3058381,-85.6816455,private,0,0,70,0,0,70,70,31,0,66,0,0,97,97,3.053608364
49740,32.7739424,-113.910905,16300,42.0863293,-91.6311439,private,22,57,19,0,57,41,98,24,49,40,0,49,64,113,3.063582013
31080,34.1087033,-118.1827533,20500,36.0605886,-78.9897875,private,0,0,64,0,0,64,64,0,0,63,0,0,63,63,3.03241436
31080,34.1087033,-118.1827533,22220,36.1163935,-94.0795449,private,12,0,98,0,0,110,110,37,0,144,0,0,181,181,3.105970022
43220,47.3541257,-123.1738498,35840,27.3642461,-82.3193579,private,12,12,17,0,12,29,41,24,12,16,0,12,40,52,3.025557476
43220,47.3541257,-123.1738498,22660,40.6580933,-105.4867638,private,17,0,24,0,0,41,41,18,0,34,0,0,52,52,3.025557476
37980,39.8949576,-75.3119824,10380,18.3569648,-67.0078951,private,17,0,34,0,0,51,51,0,0,47,0,0,47,47,3.022440711
33100,26.1018281,-80.4787552,35980,41.4726517,-72.1086339,private,0,26,36,0,26,36,62,0,19,23,0,19,23,42,3.019323945
33100,26.1018281,-80.4787552,45860,41.7918833,-73.2354042,private,0,25,40,0,25,40,65,0,29,29,0,29,29,58,3.029297594
16980,41.8235214,-87.8282967,15140,35.5866782,-89.2826913,private,36,0,122,0,0,158,158,61,0,94,0,0,155,155,3.089762842
19100,32.8491708,-96.9704894,10140,47.1137324,-123.8267349,private,15,0,64,0,0,79,79,0,0,52,0,0,52,52,3.025557476
49740,32.7739424,-113.910905,23060,41.1131166,-85.2177047,private,22,25,37,0,25,59,84,0,35,17,0,35,17,52,3.025557476
43220,47.3541257,-123.1738498,12540,35.3466288,-118.7295064,private,24,0,44,0,0,68,68,11,0,33,0,0,44,44,3.020570651
35620,40.77493,-73.873758,44300,40.9091275,-77.8478769,private,0,0,31,0,0,31,31,0,0,83,0,0,83,83,3.044881421
35620,40.77493,-73.873758,20660,38.7483486,-76.1784757,private,0,0,22,0,0,22,22,0,18,59,0,18,59,77,3.041141303
12060,33.693728,-84.3999113,41540,38.3995211,-75.4782615,private,0,0,63,0,0,63,63,15,0,54,0,0,69,69,3.036154478
16980,41.8235214,-87.8282967,45780,41.5553128,-83.5170883,private,0,0,34,0,0,34,34,0,0,51,0,0,51,51,3.024934123
26420,29.7495926,-95.3536422,19430,39.8288538,-84.1418129,private,0,0,29,0,0,29,29,12,0,39,0,0,51,51,3.024934123
26420,29.7495926,-95.3536422,14500,40.0949699,-105.3976911,private,0,0,27,0,0,27,27,13,0,38,0,0,51,51,3.024934123
20900,29.2784805,-96.2296745,34980,36.1181822,-86.6441196,private,40,0,29,0,0,69,69,42,0,63,0,0,105,105,3.058595189
41860,37.7737185,-122.2744317,27220,44.048662,-110.426087,private,0,0,12,0,0,12,12,15,11,25,0,11,40,51,3.024934123
42660,47.4905993,-121.833996,17140,39.0998213,-84.4804072,private,11,0,108,0,0,119,119,11,0,90,0,0,101,101,3.056101777
47900,38.7982054,-77.4868816,31140,38.3058381,-85.6816455,private,12,0,38,0,0,50,50,0,0,33,0,0,33,33,3.013713768
12060,33.693728,-84.3999113,31340,37.3649258,-79.2166894,private,17,0,85,0,0,102,102,0,0,47,0,0,47,47,3.022440711
33100,26.1018281,-80.4787552,10420,41.1466395,-81.3501104,private,13,22,15,0,22,28,50,12,13,19,0,13,31,44,3.020570651
33460,45.096664,-93.275361,22220,36.1163935,-94.0795449,private,26,0,62,0,0,88,88,15,0,93,0,0,108,108,3.060465248
19100,32.8491708,-96.9704894,36100,29.2028047,-82.0431004,private,13,0,50,0,0,63,63,0,0,57,0,0,57,57,3.028674241
19100,32.8491708,-96.9704894,33700,37.5623162,-121.0028311,private,16,0,34,0,0,50,50,0,0,46,0,0,46,46,3.021817358
26420,29.7495926,-95.3536422,34940,26.118786,-81.4009553,private,15,0,35,0,0,50,50,16,0,38,0,0,54,54,3.026804182
49740,32.7739424,-113.910905,35620,40.77493,-73.873758,private,13,29,115,0,29,128,157,0,26,124,0,26,124,150,3.086646077
34580,48.4932917,-121.8157703,25840,45.5446021,-119.0761905,private,11,0,39,0,0,50,50,0,0,32,0,0,32,32,3.013090415
35620,40.77493,-73.873758,49180,36.0788515,-80.3450642,private,0,0,79,0,0,79,79,12,0,145,0,0,157,157,3.091009549
35620,40.77493,-73.873758,35100,35.1168292,-77.0813197,private,0,0,78,0,0,78,78,0,14,114,0,14,114,128,3.07293231
47900,38.7982054,-77.4868816,25180,39.5544327,-77.9845935,private,0,0,33,0,0,33,33,0,0,50,0,0,50,50,3.02431077
47900,38.7982054,-77.4868816,17820,38.8455072,-104.6387277,private,0,0,37,0,0,37,37,11,0,39,0,0,50,50,3.02431077
33100,26.1018281,-80.4787552,10900,40.7893392,-75.398158,private,12,0,69,0,0,81,81,0,15,113,0,15,113,128,3.07293231
33100,26.1018281,-80.4787552,12260,33.4603713,-81.9828327,private,23,0,118,0,0,141,141,24,0,129,0,0,153,153,3.088516136
33460,45.096664,-93.275361,36380,27.3855924,-80.8873884,private,0,60,20,0,60,20,80,0,65,47,0,65,47,112,3.06295866
33460,45.096664,-93.275361,34580,48.4932917,-121.8157703,private,12,0,82,0,0,94,94,0,0,86,0,0,86,86,3.04675148
16980,41.8235214,-87.8282967,45940,40.2825026,-74.703724,private,0,0,71,0,0,71,71,0,0,76,0,0,76,76,3.04051795
31080,34.1087033,-118.1827533,25540,41.7186503,-72.5739191,private,0,0,74,0,0,74,74,0,0,108,0,0,108,108,3.060465248
31080,34.1087033,-118.1827533,36540,41.2904587,-95.9999701,private,0,0,73,0,0,73,73,0,0,94,0,0,94,94,3.051738305
41860,37.7737185,-122.2744317,12700,41.7990145,-70.2118803,private,0,0,27,0,0,27,27,0,11,57,0,11,57,68,3.035531125
41860,37.7737185,-122.2744317,35300,41.3497185,-72.9002033,private,0,0,76,0,0,76,76,0,0,117,0,0,117,117,3.066075426
41860,37.7737185,-122.2744317,28140,38.9318494,-94.4438241,private,0,0,53,0,0,53,53,0,0,86,0,0,86,86,3.04675148
34580,48.4932917,-121.8157703,13740,45.6371402,-108.8323611,private,15,0,54,0,0,69,69,31,0,50,0,0,81,81,3.043634715
34580,48.4932917,-121.8157703,36420,35.4309676,-97.5069659,private,31,0,56,0,0,87,87,39,0,57,0,0,96,96,3.052985011
14460,42.517606,-71.0219925,33340,43.0176601,-87.4815541,private,0,0,49,0,0,49,49,0,0,79,0,0,79,79,3.042388009
37980,39.8949576,-75.3119824,25540,41.7186503,-72.5739191,private,13,0,92,0,0,105,105,0,0,94,0,0,94,94,3.051738305
37980,39.8949576,-75.3119824,26900,39.74867,-86.2123823,private,13,0,85,0,0,98,98,0,0,117,0,0,117,117,3.066075426
12060,33.693728,-84.3999113,16820,37.9490837,-78.5932062,private,13,0,79,0,0,92,92,0,0,64,0,0,64,64,3.033037713
12060,33.693728,-84.3999113,24340,43.0375977,-85.7781669,private,11,0,78,0,0,89,89,0,0,68,0,0,68,68,3.035531125
33460,45.096664,-93.275361,40900,38.7896779,-121.0057504,private,0,0,181,0,0,181,181,0,0,145,0,0,145,145,3.083529312
16980,41.8235214,-87.8282967,36420,35.4309676,-97.5069659,private,11,0,128,0,0,139,139,12,0,111,0,0,123,123,3.069815544
19100,32.8491708,-96.9704894,22900,35.4631192,-94.2997413,private,22,0,41,0,0,63,63,0,0,89,0,0,89,89,3.04862154
49740,32.7739424,-113.910905,16740,35.1663423,-80.7972848,private,52,0,102,0,0,154,154,39,0,78,0,0,117,117,3.066075426
43220,47.3541257,-123.1738498,41500,36.240107,-121.3155723,private,25,0,24,0,0,49,49,16,0,33,0,0,49,49,3.023687417
35620,40.77493,-73.873758,27220,44.048662,-110.426087,private,0,0,0,0,0,0,0,0,15,49,0,15,49,64,3.033037713
35620,40.77493,-73.873758,37860,30.6554013,-87.1618275,private,0,0,52,0,0,52,52,0,0,91,0,0,91,91,3.049868246
37980,39.8949576,-75.3119824,17900,34.0775845,-81.0378453,private,12,0,85,0,0,97,97,11,0,132,0,0,143,143,3.082282606
47900,38.7982054,-77.4868816,25540,41.7186503,-72.5739191,private,0,0,56,0,0,56,56,0,0,78,0,0,78,78,3.041764656
33100,26.1018281,-80.4787552,25940,32.3867916,-80.8308775,private,14,0,48,0,0,62,62,11,0,63,0,0,74,74,3.039271244
20900,29.2784805,-96.2296745,12940,30.5187808,-91.1255901,private,31,0,61,0,0,92,92,31,0,64,0,0,95,95,3.052361658
38060,33.1857653,-112.0678624,25740,46.8113536,-112.2840307,private,11,27,39,0,27,50,77,20,26,14,0,26,34,60,3.030544301
38060,33.1857653,-112.0678624,41500,36.240107,-121.3155723,private,0,12,37,0,12,37,49,12,0,65,0,0,77,77,3.041141303
34580,48.4932917,-121.8157703,47900,38.7982054,-77.4868816,private,34,0,110,0,0,144,144,12,0,108,0,0,120,120,3.067945485
43220,47.3541257,-123.1738498,17020,39.6659588,-121.6019188,private,13,0,26,0,0,39,39,21,0,28,0,0,49,49,3.023687417
14460,42.517606,-71.0219925,10740,35.1234965,-106.4583918,private,0,0,48,0,0,48,48,0,0,48,0,0,48,48,3.023064064
12060,33.693728,-84.3999113,41620,40.5728869,-112.9532527,private,13,0,67,0,0,80,80,0,0,69,0,0,69,69,3.036154478
33460,45.096664,-93.275361,12580,39.304361,-76.5495009,private,0,0,128,0,0,128,128,0,0,80,0,0,80,80,3.043011362
16980,41.8235214,-87.8282967,33660,30.9715095,-88.20787,private,27,55,66,0,55,93,148,16,0,97,0,0,113,113,3.063582013
16980,41.8235214,-87.8282967,21340,31.527394,-105.5213326,private,28,0,122,0,0,150,150,0,0,81,0,0,81,81,3.043634715
26420,29.7495926,-95.3536422,24340,43.0375977,-85.7781669,private,11,0,37,0,0,48,48,13,0,19,0,0,32,32,3.013090415
38060,33.1857653,-112.0678624,16220,42.9776447,-106.7682192,private,14,32,32,0,32,46,78,0,38,31,0,38,31,69,3.036154478
42660,47.4905993,-121.833996,22220,36.1163935,-94.0795449,private,22,0,63,0,0,85,85,22,0,51,0,0,73,73,3.038647891
34580,48.4932917,-121.8157703,41620,40.5728869,-112.9532527,private,0,0,48,0,0,48,48,13,0,33,0,0,46,46,3.021817358
42660,47.4905993,-121.833996,30020,34.5291104,-98.4309172,private,22,0,26,0,0,48,48,25,0,39,0,0,64,64,3.033037713
14460,42.517606,-71.0219925,17820,38.8455072,-104.6387277,private,0,0,29,0,0,29,29,0,0,48,0,0,48,48,3.023064064
35620,40.77493,-73.873758,28940,36.0147907,-84.2067014,private,0,0,44,0,0,44,44,0,0,100,0,0,100,100,3.055478423
37980,39.8949576,-75.3119824,39300,41.7068313,-71.2866369,private,0,12,114,0,12,114,126,11,21,142,0,21,153,174,3.101606551
37980,39.8949576,-75.3119824,35380,29.805532,-89.7013821,private,0,0,79,0,0,79,79,0,0,61,0,0,61,61,3.031167654
47900,38.7982054,-77.4868816,41620,40.5728869,-112.9532527,private,0,0,31,0,0,31,31,0,0,48,0,0,48,48,3.023064064
47900,38.7982054,-77.4868816,41500,36.240107,-121.3155723,private,0,0,17,0,0,17,17,0,0,48,0,0,48,48,3.023064064
33100,26.1018281,-80.4787552,36300,44.4881125,-75.074311,private,0,30,27,0,30,27,57,12,24,12,0,24,24,48,3.023064064
31080,34.1087033,-118.1827533,39100,41.5752737,-74.0338729,private,0,0,50,0,0,50,50,0,0,108,0,0,108,108,3.060465248
41860,37.7737185,-122.2744317,20500,36.0605886,-78.9897875,private,0,0,66,0,0,66,66,0,0,80,0,0,80,80,3.043011362
34580,48.4932917,-121.8157703,46520,21.5800225,-158.1234063,private,0,0,30,0,0,30,30,17,0,31,0,0,48,48,3.023064064
43220,47.3541257,-123.1738498,15980,26.5590348,-81.8919943,private,0,0,21,0,0,21,21,15,14,19,0,14,34,48,3.023064064
43220,47.3541257,-123.1738498,20900,29.2784805,-96.2296745,private,22,0,19,0,0,41,41,18,0,30,0,0,48,48,3.023064064
14460,42.517606,-71.0219925,34580,48.4932917,-121.8157703,private,0,0,47,0,0,47,47,0,0,29,0,0,29,29,3.011220355
33100,26.1018281,-80.4787552,28020,42.2462657,-85.5328544,private,11,23,28,0,23,39,62,0,29,38,0,29,38,67,3.034907772
33100,26.1018281,-80.4787552,20500,36.0605886,-78.9897875,private,11,0,61,0,0,72,72,0,0,71,0,0,71,71,3.037401184
19100,32.8491708,-96.9704894,34780,35.6175506,-95.3839106,private,13,0,63,0,0,76,76,24,0,51,0,0,75,75,3.039894597
20900,29.2784805,-96.2296745,27260,30.2365943,-81.7544462,private,32,0,60,0,0,92,92,24,0,33,0,0,57,57,3.028674241
38060,33.1857653,-112.0678624,17140,39.0998213,-84.4804072,private,35,0,122,0,0,157,157,12,0,130,0,0,142,142,3.081659253
38060,33.1857653,-112.0678624,12540,35.3466288,-118.7295064,private,14,0,137,0,0,151,151,0,0,133,0,0,133,133,3.076049075
38060,33.1857653,-112.0678624,23060,41.1131166,-85.2177047,private,17,14,74,0,14,91,105,36,23,66,0,23,102,125,3.07106225
49740,32.7739424,-113.910905,38860,43.6514172,-70.4183755,private,0,29,18,0,29,18,47,0,16,0,0,16,0,16,3.003116765
35620,40.77493,-73.873758,28300,42.9254596,-72.2481828,private,0,0,0,0,0,0,0,0,18,56,0,18,56,74,3.039271244
35620,40.77493,-73.873758,14260,43.0066485,-116.1419089,private,0,0,33,0,0,33,33,0,0,99,0,0,99,99,3.05485507
12060,33.693728,-84.3999113,27740,36.2658223,-82.3326926,private,14,0,112,0,0,126,126,37,0,78,0,0,115,115,3.06482872
12060,33.693728,-84.3999113,10740,35.1234965,-106.4583918,private,0,0,78,0,0,78,78,0,0,99,0,0,99,99,3.05485507
33460,45.096664,-93.275361,47980,44.8524086,-97.1770994,private,11,0,43,0,0,54,54,24,0,76,0,0,100,100,3.055478423
16980,41.8235214,-87.8282967,28660,31.2027301,-97.7896384,private,0,0,123,0,0,123,123,14,0,124,0,0,138,138,3.07916584
16980,41.8235214,-87.8282967,12700,41.7990145,-70.2118803,private,0,0,11,0,0,11,11,0,22,36,0,22,36,58,3.029297594
16980,41.8235214,-87.8282967,29940,38.8964168,-95.2909475,private,12,0,58,0,0,70,70,0,0,96,0,0,96,96,3.052985011
16980,41.8235214,-87.8282967,46140,36.2544287,-96.1773294,private,0,0,85,0,0,85,85,12,0,138,0,0,150,150,3.086646077
19100,32.8491708,-96.9704894,28940,36.0147907,-84.2067014,private,11,0,55,0,0,66,66,17,0,96,0,0,113,113,3.063582013
38060,33.1857653,-112.0678624,10100,45.5194353,-98.7007003,private,34,51,0,0,51,34,85,29,47,17,0,47,46,93,3.051114952
49740,32.7739424,-113.910905,25540,41.7186503,-72.5739191,private,12,0,12,0,0,24,24,11,0,36,0,0,47,47,3.022440711
49740,32.7739424,-113.910905,48780,48.3557649,-103.5013332,private,0,26,15,0,26,15,41,11,25,11,0,25,22,47,3.022440711
31080,34.1087033,-118.1827533,35300,41.3497185,-72.9002033,private,0,0,106,0,0,106,106,0,0,111,0,0,111,111,3.062335307
31080,34.1087033,-118.1827533,44060,48.091618,-117.663472,private,12,0,198,0,0,210,210,11,0,173,0,0,184,184,3.107840082
41860,37.7737185,-122.2744317,31540,43.0842941,-89.5971796,private,0,0,67,0,0,67,67,0,0,93,0,0,93,93,3.051114952
42660,47.4905993,-121.833996,13740,45.6371402,-108.8323611,private,0,0,74,0,0,74,74,36,0,92,0,0,128,128,3.07293231
43220,47.3541257,-123.1738498,29460,27.9536488,-81.6935337,private,0,0,20,0,0,20,20,11,0,36,0,0,47,47,3.022440711
33100,26.1018281,-80.4787552,11220,42.9008912,-74.4353575,private,19,15,26,0,15,45,60,13,14,27,0,14,40,54,3.026804182
33100,26.1018281,-80.4787552,17900,34.0775845,-81.0378453,private,56,0,127,0,0,183,183,12,0,119,0,0,131,131,3.074802369
33100,26.1018281,-80.4787552,32820,35.0244194,-89.8719712,private,11,0,54,0,0,65,65,0,0,34,0,0,34,34,3.014337121
38060,33.1857653,-112.0678624,38860,43.6514172,-70.4183755,private,0,33,24,0,33,24,57,14,23,20,0,23,34,57,3.028674241
38060,33.1857653,-112.0678624,46520,21.5800225,-158.1234063,private,11,0,75,0,0,86,86,0,0,51,0,0,51,51,3.024934123
49740,32.7739424,-113.910905,16860,35.0493612,-85.3611582,private,22,0,24,0,0,46,46,0,0,28,0,0,28,28,3.010597002
49740,32.7739424,-113.910905,37940,40.7728833,-86.0442575,private,17,17,12,0,17,29,46,0,11,0,0,11,0,11,3
35620,40.77493,-73.873758,10420,41.1466395,-81.3501104,private,0,0,31,0,0,31,31,0,0,136,0,0,136,136,3.077919134
12060,33.693728,-84.3999113,15680,38.2202894,-76.5303837,private,0,0,54,0,0,54,54,0,0,72,0,0,72,72,3.038024537
33100,26.1018281,-80.4787552,41620,40.5728869,-112.9532527,private,0,0,53,0,0,53,53,0,0,65,0,0,65,65,3.033661066
16980,41.8235214,-87.8282967,17860,38.9864864,-92.5851888,private,0,0,80,0,0,80,80,0,0,120,0,0,120,120,3.067945485
16980,41.8235214,-87.8282967,46380,39.4323876,-123.4428811,private,0,0,30,0,0,30,30,12,0,34,0,0,46,46,3.021817358
49740,32.7739424,-113.910905,21700,40.7066554,-123.9261757,private,0,14,16,0,14,16,30,0,16,30,0,16,30,46,3.021817358
41860,37.7737185,-122.2744317,17820,38.8455072,-104.6387277,private,0,0,38,0,0,38,38,13,0,65,0,0,78,78,3.041764656
34580,48.4932917,-121.8157703,34980,36.1181822,-86.6441196,private,13,0,33,0,0,46,46,29,0,48,0,0,77,77,3.041141303
43220,47.3541257,-123.1738498,47900,38.7982054,-77.4868816,private,81,0,133,0,0,214,214,51,0,168,0,0,219,219,3.129657439
43220,47.3541257,-123.1738498,39580,35.7567464,-78.4604412,private,14,0,20,0,0,34,34,24,0,36,0,0,60,60,3.030544301
33100,26.1018281,-80.4787552,22660,40.6580933,-105.4867638,private,19,0,50,0,0,69,69,0,0,48,0,0,48,48,3.023064064
19100,32.8491708,-96.9704894,26260,33.7008395,-93.4995489,private,19,0,38,0,0,57,57,0,0,74,0,0,74,74,3.039271244
26420,29.7495926,-95.3536422,40060,37.4113241,-77.4418164,private,0,0,74,0,0,74,74,0,0,78,0,0,78,78,3.041764656
49740,32.7739424,-113.910905,37340,28.2983112,-80.7003334,private,19,0,26,0,0,45,45,15,0,24,0,0,39,39,3.017453886
14460,42.517606,-71.0219925,42200,34.5370572,-120.0399729,private,0,0,32,0,0,32,32,0,0,45,0,0,45,45,3.021194004
35620,40.77493,-73.873758,12020,33.943984,-83.2138965,private,0,0,44,0,0,44,44,0,0,75,0,0,75,75,3.039894597
47900,38.7982054,-77.4868816,12100,39.4693555,-74.6337591,private,0,0,14,0,0,14,14,0,14,31,0,14,31,45,3.021194004
12060,33.693728,-84.3999113,43220,47.3541257,-123.1738498,private,13,0,46,0,0,59,59,15,0,58,0,0,73,73,3.038647891
16980,41.8235214,-87.8282967,10300,41.8960225,-84.0743563,private,0,0,42,0,0,42,42,0,0,60,0,0,60,60,3.030544301
19100,32.8491708,-96.9704894,28020,42.2462657,-85.5328544,private,16,0,31,0,0,47,47,11,0,59,0,0,70,70,3.036777831
26420,29.7495926,-95.3536422,27140,32.4282801,-90.2023875,private,11,0,89,0,0,100,100,15,0,99,0,0,114,114,3.064205367
49740,32.7739424,-113.910905,41540,38.3995211,-75.4782615,private,12,11,15,0,11,27,38,19,14,12,0,14,31,45,3.021194004
49740,32.7739424,-113.910905,22180,35.1559863,-78.93185,private,0,0,22,0,0,22,22,14,0,31,0,0,45,45,3.021194004
49740,32.7739424,-113.910905,49660,41.23646,-80.5617836,private,0,26,0,0,26,0,26,11,17,29,0,17,40,57,3.028674241
31080,34.1087033,-118.1827533,37340,28.2983112,-80.7003334,private,25,0,113,0,0,138,138,12,0,121,0,0,133,133,3.076049075
42660,47.4905993,-121.833996,19820,42.7218478,-83.2008463,private,12,0,139,0,0,151,151,27,0,197,0,0,224,224,3.132774205
37980,39.8949576,-75.3119824,41620,40.5728869,-112.9532527,private,0,0,44,0,0,44,44,0,0,42,0,0,42,42,3.019323945
33100,26.1018281,-80.4787552,38340,42.371493,-73.2179276,private,0,69,0,0,69,0,69,15,50,0,0,50,15,65,3.033661066
19100,32.8491708,-96.9704894,14010,40.4945594,-88.8445391,private,15,0,29,0,0,44,44,14,0,36,0,0,50,50,3.02431077
38060,33.1857653,-112.0678624,44180,37.3608699,-93.1802617,private,41,23,109,0,23,150,173,64,0,171,0,0,235,235,3.139631088
38060,33.1857653,-112.0678624,37900,40.7088872,-89.6974658,private,12,32,68,0,32,80,112,12,12,33,0,12,45,57,3.028674241
41860,37.7737185,-122.2744317,18140,39.9685617,-82.8359105,private,0,0,75,0,0,75,75,0,0,107,0,0,107,107,3.059841895
43220,47.3541257,-123.1738498,45300,28.1259071,-82.4652858,private,12,0,93,0,0,105,105,14,0,107,0,0,121,121,3.068568838
43220,47.3541257,-123.1738498,29940,38.8964168,-95.2909475,private,24,0,20,0,0,44,44,15,0,25,0,0,40,40,3.018077239
35620,40.77493,-73.873758,28020,42.2462657,-85.5328544,private,0,0,34,0,0,34,34,0,13,53,0,13,53,66,3.034284419
35620,40.77493,-73.873758,15620,44.3287385,-85.3264287,private,0,0,0,0,0,0,0,0,17,48,0,17,48,65,3.033661066
35620,40.77493,-73.873758,46140,36.2544287,-96.1773294,private,0,0,33,0,0,33,33,0,0,112,0,0,112,112,3.06295866
37980,39.8949576,-75.3119824,18500,42.2667252,-77.3855253,private,0,0,44,0,0,44,44,0,0,56,0,0,56,56,3.028050888
37980,39.8949576,-75.3119824,19820,42.7218478,-83.2008463,private,0,0,115,0,0,115,115,11,0,118,0,0,129,129,3.073555663
47900,38.7982054,-77.4868816,44140,42.3648332,-72.6194063,private,0,0,33,0,0,33,33,0,0,44,0,0,44,44,3.020570651
47900,38.7982054,-77.4868816,37340,28.2983112,-80.7003334,private,0,0,28,0,0,28,28,0,11,33,0,11,33,44,3.020570651
12060,33.693728,-84.3999113,29180,29.9577733,-92.0493498,private,0,0,77,0,0,77,77,0,0,56,0,0,56,56,3.028050888
33460,45.096664,-93.275361,17460,41.7603919,-81.7242168,private,12,0,65,0,0,77,77,0,0,82,0,0,82,82,3.044258068
33460,45.096664,-93.275361,25720,40.6913977,-111.0527658,private,44,0,76,0,0,120,120,31,0,76,0,0,107,107,3.059841895
16980,41.8235214,-87.8282967,32460,36.7233435,-88.6498974,private,31,0,43,0,0,74,74,13,0,102,0,0,115,115,3.06482872
19100,32.8491708,-96.9704894,48900,34.4260331,-77.889634,private,14,0,26,0,0,40,40,18,0,44,0,0,62,62,3.031791007
19100,32.8491708,-96.9704894,44180,37.3608699,-93.1802617,private,42,0,74,0,0,116,116,33,0,80,0,0,113,113,3.063582013
26420,29.7495926,-95.3536422,45500,33.4783701,-94.2071694,private,16,0,49,0,0,65,65,13,0,71,0,0,84,84,3.045504774
26420,29.7495926,-95.3536422,12540,35.3466288,-118.7295064,private,28,0,33,0,0,61,61,14,0,53,0,0,67,67,3.034907772
49740,32.7739424,-113.910905,40540,41.6603282,-108.8756774,private,13,30,0,0,30,13,43,0,29,15,0,29,15,44,3.020570651
31080,34.1087033,-118.1827533,25940,32.3867916,-80.8308775,private,0,0,12,0,0,12,12,0,0,69,0,0,69,69,3.036154478
43220,47.3541257,-123.1738498,36740,28.4343962,-81.3560839,private,28,0,50,0,0,78,78,37,0,64,0,0,101,101,3.056101777
33100,26.1018281,-80.4787552,44140,42.3648332,-72.6194063,private,11,15,51,0,15,62,77,0,12,43,0,12,43,55,3.027427535
33100,26.1018281,-80.4787552,41940,36.9084718,-121.3713721,private,14,0,78,0,0,92,92,0,0,89,0,0,89,89,3.04862154
33460,45.096664,-93.275361,20500,36.0605886,-78.9897875,private,0,0,59,0,0,59,59,0,0,19,0,0,19,19,3.004986825
33460,45.096664,-93.275361,13900,46.887031,-100.979592,private,11,0,81,0,0,92,92,0,0,81,0,0,81,81,3.043634715
33460,45.096664,-93.275361,43220,47.3541257,-123.1738498,private,16,0,76,0,0,92,92,28,0,60,0,0,88,88,3.047998187
19100,32.8491708,-96.9704894,14860,41.2274128,-73.3670614,private,15,0,54,0,0,69,69,12,0,44,0,0,56,56,3.028050888
20900,29.2784805,-96.2296745,35620,40.77493,-73.873758,private,26,0,88,0,0,114,114,11,0,99,0,0,110,110,3.061711954
20900,29.2784805,-96.2296745,16740,35.1663423,-80.7972848,private,26,0,58,0,0,84,84,0,0,49,0,0,49,49,3.023687417
38060,33.1857653,-112.0678624,11700,35.5956693,-82.6816145,private,11,11,35,0,11,46,57,0,13,65,0,13,65,78,3.041764656
49740,32.7739424,-113.910905,19430,39.8288538,-84.1418129,private,25,0,54,0,0,79,79,17,0,48,0,0,65,65,3.033661066
34580,48.4932917,-121.8157703,13940,43.2163568,-112.3992058,private,0,0,43,0,0,43,43,11,0,11,0,0,22,22,3.006856884
35620,40.77493,-73.873758,47220,39.3284336,-75.1216277,private,0,0,20,0,0,20,20,14,0,77,0,0,91,91,3.049868246
47900,38.7982054,-77.4868816,25500,38.5075848,-78.8853213,private,0,0,13,0,0,13,13,0,11,32,0,11,32,43,3.019947298
47900,38.7982054,-77.4868816,24860,34.6837085,-82.4134227,private,0,0,30,0,0,30,30,0,0,43,0,0,43,43,3.019947298
47900,38.7982054,-77.4868816,25940,32.3867916,-80.8308775,private,0,0,13,0,0,13,13,0,14,29,0,14,29,43,3.019947298
47900,38.7982054,-77.4868816,22660,40.6580933,-105.4867638,private,0,0,33,0,0,33,33,0,0,43,0,0,43,43,3.019947298
33100,26.1018281,-80.4787552,28740,41.9472124,-74.2654582,private,0,30,0,0,30,0,30,0,37,17,0,37,17,54,3.026804182
33100,26.1018281,-80.4787552,46060,32.1280427,-111.7836574,private,11,0,63,0,0,74,74,12,0,64,0,0,76,76,3.04051795
19100,32.8491708,-96.9704894,22620,35.0228383,-90.7515053,private,0,0,19,0,0,19,19,15,0,40,0,0,55,55,3.027427535
49740,32.7739424,-113.910905,16100,32.4578347,-104.3064338,private,13,0,24,0,0,37,37,13,0,30,0,0,43,43,3.019947298
31080,34.1087033,-118.1827533,22180,35.1559863,-78.93185,private,0,0,70,0,0,70,70,0,0,67,0,0,67,67,3.034907772
31080,34.1087033,-118.1827533,28060,48.3146779,-114.0542951,private,0,0,13,0,0,13,13,44,11,80,0,11,124,135,3.077295781
41860,37.7737185,-122.2744317,39300,41.7068313,-71.2866369,private,0,0,62,0,0,62,62,11,0,95,0,0,106,106,3.059218542
42660,47.4905993,-121.833996,24860,34.6837085,-82.4134227,private,0,0,40,0,0,40,40,16,0,75,0,0,91,91,3.049868246
42660,47.4905993,-121.833996,36540,41.2904587,-95.9999701,private,0,0,40,0,0,40,40,16,0,59,0,0,75,75,3.039894597
42660,47.4905993,-121.833996,33340,43.0176601,-87.4815541,private,13,0,130,0,0,143,143,0,0,94,0,0,94,94,3.051738305
42660,47.4905993,-121.833996,17020,39.6659588,-121.6019188,private,0,0,57,0,0,57,57,0,0,89,0,0,89,89,3.04862154
34580,48.4932917,-121.8157703,39580,35.7567464,-78.4604412,private,0,0,19,0,0,19,19,15,0,28,0,0,43,43,3.019947298
34580,48.4932917,-121.8157703,33100,26.1018281,-80.4787552,private,0,13,82,0,13,82,95,15,17,74,0,17,89,106,3.059218542
34580,48.4932917,-121.8157703,33460,45.096664,-93.275361,private,0,0,73,0,0,73,73,11,0,97,0,0,108,108,3.060465248
34580,48.4932917,-121.8157703,39900,40.5007953,-119.7311608,private,0,0,32,0,0,32,32,11,0,32,0,0,43,43,3.019947298
37980,39.8949576,-75.3119824,41940,36.9084718,-121.3713721,private,0,0,135,0,0,135,135,0,0,101,0,0,101,101,3.056101777
19100,32.8491708,-96.9704894,46520,21.5800225,-158.1234063,private,11,0,31,0,0,42,42,12,0,18,0,0,30,30,3.011843708
26420,29.7495926,-95.3536422,37260,29.5938964,-81.7320389,private,25,0,28,0,0,53,53,0,0,57,0,0,57,57,3.028674241
20900,29.2784805,-96.2296745,39580,35.7567464,-78.4604412,private,20,0,34,0,0,54,54,17,0,37,0,0,54,54,3.026804182
20900,29.2784805,-96.2296745,16980,41.8235214,-87.8282967,private,44,0,130,0,0,174,174,22,0,135,0,0,157,157,3.091009549
43220,47.3541257,-123.1738498,26420,29.7495926,-95.3536422,private,38,0,43,0,0,81,81,25,0,42,0,0,67,67,3.034907772
35620,40.77493,-73.873758,30460,38.1028763,-84.4385451,private,0,0,53,0,0,53,53,0,0,123,0,0,123,123,3.069815544
35620,40.77493,-73.873758,36540,41.2904587,-95.9999701,private,0,0,48,0,0,48,48,0,0,95,0,0,95,95,3.052361658
35620,40.77493,-73.873758,40700,43.2863277,-123.154476,private,0,0,29,0,0,29,29,0,0,71,0,0,71,71,3.037401184
47900,38.7982054,-77.4868816,31540,43.0842941,-89.5971796,private,0,0,52,0,0,52,52,0,0,66,0,0,66,66,3.034284419
12060,33.693728,-84.3999113,36420,35.4309676,-97.5069659,private,28,0,100,0,0,128,128,12,0,170,0,0,182,182,3.106593375
33100,26.1018281,-80.4787552,36420,35.4309676,-97.5069659,private,0,0,33,0,0,33,33,11,0,101,0,0,112,112,3.06295866
33460,45.096664,-93.275361,16700,33.0180695,-80.0075006,private,0,0,46,0,0,46,46,22,0,66,0,0,88,88,3.047998187
26420,29.7495926,-95.3536422,22180,35.1559863,-78.93185,private,24,0,41,0,0,65,65,0,0,60,0,0,60,60,3.030544301
38060,33.1857653,-112.0678624,31460,37.2098213,-119.7498023,private,14,0,39,0,0,53,53,14,0,60,0,0,74,74,3.039271244
49740,32.7739424,-113.910905,24860,34.6837085,-82.4134227,private,0,0,20,0,0,20,20,13,0,29,0,0,42,42,3.019323945
49740,32.7739424,-113.910905,39540,42.7541215,-87.4208775,private,0,0,0,0,0,0,0,11,13,18,0,13,29,42,3.019323945
49740,32.7739424,-113.910905,31180,33.4703271,-101.6488249,private,0,0,0,0,0,0,0,14,0,28,0,0,42,42,3.019323945
31080,34.1087033,-118.1827533,33540,47.0272632,-113.8926911,private,0,0,30,0,0,30,30,18,0,75,0,0,93,93,3.051114952
41860,37.7737185,-122.2744317,33340,43.0176601,-87.4815541,private,0,0,22,0,0,22,22,0,0,102,0,0,102,102,3.05672513
34580,48.4932917,-121.8157703,36740,28.4343962,-81.3560839,private,28,0,66,0,0,94,94,35,0,60,0,0,95,95,3.052361658
33100,26.1018281,-80.4787552,20700,41.0562401,-75.3290651,private,0,17,35,0,17,35,52,0,15,25,0,15,25,40,3.018077239
38060,33.1857653,-112.0678624,40380,43.148038,-77.5232575,private,11,42,75,0,42,86,128,12,16,73,0,16,85,101,3.056101777
38060,33.1857653,-112.0678624,36900,41.0312751,-92.4094658,private,11,15,15,0,15,26,41,0,11,20,0,11,20,31,3.012467061
38060,33.1857653,-112.0678624,22140,36.5116245,-108.3245778,private,15,0,55,0,0,70,70,0,0,70,0,0,70,70,3.036777831
31080,34.1087033,-118.1827533,31540,43.0842941,-89.5971796,private,0,0,69,0,0,69,69,0,0,82,0,0,82,82,3.044258068
42660,47.4905993,-121.833996,40060,37.4113241,-77.4418164,private,24,0,101,0,0,125,125,11,0,82,0,0,93,93,3.051114952
14460,42.517606,-71.0219925,47260,36.8044077,-76.4495261,private,0,0,73,0,0,73,73,0,0,91,0,0,91,91,3.049868246
14460,42.517606,-71.0219925,13820,33.4025986,-86.7295151,private,0,0,17,0,0,17,17,11,0,30,0,0,41,41,3.018700592
35620,40.77493,-73.873758,48580,42.6681095,-88.5417306,private,0,0,25,0,0,25,25,0,0,70,0,0,70,70,3.036777831
47900,38.7982054,-77.4868816,28140,38.9318494,-94.4438241,private,0,0,52,0,0,52,52,0,0,72,0,0,72,72,3.038024537
12060,33.693728,-84.3999113,23060,41.1131166,-85.2177047,private,0,0,45,0,0,45,45,0,0,60,0,0,60,60,3.030544301
33100,26.1018281,-80.4787552,35380,29.805532,-89.7013821,private,0,0,129,0,0,129,129,0,0,127,0,0,127,127,3.072308956
19100,32.8491708,-96.9704894,48580,42.6681095,-88.5417306,private,0,0,40,0,0,40,40,13,0,43,0,0,56,56,3.028050888
19100,32.8491708,-96.9704894,35060,31.7325509,-93.0826114,private,0,0,58,0,0,58,58,12,0,57,0,0,69,69,3.036154478
38060,33.1857653,-112.0678624,23420,36.7610058,-119.6550193,private,0,0,55,0,0,55,55,0,0,72,0,0,72,72,3.038024537
49740,32.7739424,-113.910905,29460,27.9536488,-81.6935337,private,18,0,20,0,0,38,38,16,0,25,0,0,41,41,3.018700592
31080,34.1087033,-118.1827533,15380,43.0443711,-78.7773351,private,0,0,40,0,0,40,40,0,0,63,0,0,63,63,3.03241436
31080,34.1087033,-118.1827533,11700,35.5956693,-82.6816145,private,0,0,63,0,0,63,63,0,0,122,0,0,122,122,3.069192191
31080,34.1087033,-118.1827533,34940,26.118786,-81.4009553,private,0,0,67,0,0,67,67,11,0,96,0,0,107,107,3.059841895
41860,37.7737185,-122.2744317,40060,37.4113241,-77.4418164,private,0,0,26,0,0,26,26,0,0,67,0,0,67,67,3.034907772
41860,37.7737185,-122.2744317,34940,26.118786,-81.4009553,private,0,0,31,0,0,31,31,0,0,41,0,0,41,41,3.018700592
43220,47.3541257,-123.1738498,46140,36.2544287,-96.1773294,private,0,0,34,0,0,34,34,13,0,28,0,0,41,41,3.018700592
37980,39.8949576,-75.3119824,49180,36.0788515,-80.3450642,private,0,0,40,0,0,40,40,0,0,20,0,0,20,20,3.005610178
12060,33.693728,-84.3999113,14860,41.2274128,-73.3670614,private,15,0,92,0,0,107,107,0,0,120,0,0,120,120,3.067945485
33100,26.1018281,-80.4787552,37120,31.4306536,-85.609476,private,13,0,40,0,0,53,53,0,0,38,0,0,38,38,3.016830533
33100,26.1018281,-80.4787552,15140,35.5866782,-89.2826913,private,12,0,28,0,0,40,40,0,0,34,0,0,34,34,3.014337121
33460,45.096664,-93.275361,33660,30.9715095,-88.20787,private,0,100,0,0,100,0,100,0,52,0,0,52,0,52,3.025557476
33460,45.096664,-93.275361,16300,42.0863293,-91.6311439,private,0,0,130,0,0,130,130,0,0,133,0,0,133,133,3.076049075
16980,41.8235214,-87.8282967,35100,35.1168292,-77.0813197,private,15,0,64,0,0,79,79,13,0,13,0,0,26,26,3.009350296
16980,41.8235214,-87.8282967,40380,43.148038,-77.5232575,private,0,0,51,0,0,51,51,0,0,65,0,0,65,65,3.033661066
49740,32.7739424,-113.910905,48900,34.4260331,-77.889634,private,15,12,13,0,12,28,40,21,0,19,0,0,40,40,3.018077239
49740,32.7739424,-113.910905,32380,43.2137325,-93.2743388,private,0,27,13,0,27,13,40,0,26,12,0,26,12,38,3.016830533
34580,48.4932917,-121.8157703,32580,26.3963839,-98.18099,private,16,13,11,0,13,27,40,0,0,14,0,0,14,14,3.001870059
43220,47.3541257,-123.1738498,36420,35.4309676,-97.5069659,private,24,0,28,0,0,52,52,17,0,35,0,0,52,52,3.025557476
35620,40.77493,-73.873758,34740,43.2892579,-86.751892,private,0,0,16,0,0,16,16,0,14,58,0,14,58,72,3.038024537
35620,40.77493,-73.873758,43220,47.3541257,-123.1738498,private,0,0,41,0,0,41,41,0,0,87,0,0,87,87,3.047374834
37980,39.8949576,-75.3119824,49740,32.7739424,-113.910905,private,0,0,53,0,0,53,53,11,0,64,0,0,75,75,3.039894597
37980,39.8949576,-75.3119824,31140,38.3058381,-85.6816455,private,0,0,47,0,0,47,47,0,0,40,0,0,40,40,3.018077239
47900,38.7982054,-77.4868816,40380,43.148038,-77.5232575,private,0,0,40,0,0,40,40,0,0,77,0,0,77,77,3.041141303
47900,38.7982054,-77.4868816,24660,36.0252039,-79.7926333,private,0,0,78,0,0,78,78,0,0,116,0,0,116,116,3.065452073
47900,38.7982054,-77.4868816,37860,30.6554013,-87.1618275,private,11,0,16,0,0,27,27,0,0,40,0,0,40,40,3.018077239
16980,41.8235214,-87.8282967,39150,34.631071,-112.5772247,private,54,0,52,0,0,106,106,37,13,83,0,13,120,133,3.076049075
16980,41.8235214,-87.8282967,33700,37.5623162,-121.0028311,private,0,0,19,0,0,19,19,13,0,52,0,0,65,65,3.033661066
19100,32.8491708,-96.9704894,39340,39.872067,-112.3590592,private,14,0,11,0,0,25,25,20,0,20,0,0,40,40,3.018077239
38060,33.1857653,-112.0678624,36837,41.3564879,-89.1733848,private,0,32,17,0,32,17,49,13,15,12,0,15,25,40,3.018077239
31080,34.1087033,-118.1827533,32820,35.0244194,-89.8719712,private,0,0,65,0,0,65,65,13,0,60,0,0,73,73,3.038647891
41860,37.7737185,-122.2744317,22220,36.1163935,-94.0795449,private,0,0,27,0,0,27,27,0,0,56,0,0,56,56,3.028050888
42660,47.4905993,-121.833996,15540,44.6891168,-73.0411707,private,0,0,28,0,0,28,28,0,0,62,0,0,62,62,3.031791007
34580,48.4932917,-121.8157703,16980,41.8235214,-87.8282967,private,15,0,120,0,0,135,135,13,0,102,0,0,115,115,3.06482872
12060,33.693728,-84.3999113,40220,37.2862262,-79.9469346,private,11,0,85,0,0,96,96,0,0,64,0,0,64,64,3.033037713
19100,32.8491708,-96.9704894,16860,35.0493612,-85.3611582,private,13,0,60,0,0,73,73,0,0,54,0,0,54,54,3.026804182
26420,29.7495926,-95.3536422,28020,42.2462657,-85.5328544,private,16,0,23,0,0,39,39,0,0,39,0,0,39,39,3.017453886
38060,33.1857653,-112.0678624,27620,38.6368854,-92.088876,private,11,24,16,0,24,27,51,24,14,13,0,14,37,51,3.024934123
49740,32.7739424,-113.910905,44020,43.3896107,-95.1960572,private,12,27,0,0,27,12,39,12,27,0,0,27,12,39,3.017453886
49740,32.7739424,-113.910905,36837,41.3564879,-89.1733848,private,0,27,12,0,27,12,39,0,18,13,0,18,13,31,3.012467061
49740,32.7739424,-113.910905,48620,37.637896,-97.2462875,private,17,0,36,0,0,53,53,25,0,31,0,0,56,56,3.028050888
14460,42.517606,-71.0219925,31140,38.3058381,-85.6816455,private,0,0,33,0,0,33,33,0,0,39,0,0,39,39,3.017453886
35620,40.77493,-73.873758,36460,42.2390986,-78.662332,private,0,0,0,0,0,0,0,0,13,47,0,13,47,60,3.030544301
35620,40.77493,-73.873758,22220,36.1163935,-94.0795449,private,0,0,43,0,0,43,43,0,0,72,0,0,72,72,3.038024537
35620,40.77493,-73.873758,21340,31.527394,-105.5213326,private,0,0,74,0,0,74,74,0,0,90,0,0,90,90,3.049244893
37980,39.8949576,-75.3119824,12700,41.7990145,-70.2118803,private,0,60,11,0,60,11,71,0,94,32,0,94,32,126,3.071685603
47900,38.7982054,-77.4868816,25420,40.335915,-77.0504897,private,0,0,48,0,0,48,48,0,0,57,0,0,57,57,3.028674241
47900,38.7982054,-77.4868816,37260,29.5938964,-81.7320389,private,0,0,17,0,0,17,17,0,0,39,0,0,39,39,3.017453886
47900,38.7982054,-77.4868816,20900,29.2784805,-96.2296745,private,0,0,31,0,0,31,31,0,0,39,0,0,39,39,3.017453886
33100,26.1018281,-80.4787552,30460,38.1028763,-84.4385451,private,0,0,45,0,0,45,45,12,0,47,0,0,59,59,3.029920947
19100,32.8491708,-96.9704894,10540,44.4888982,-122.5372084,private,0,0,16,0,0,16,16,14,0,25,0,0,39,39,3.017453886
38060,33.1857653,-112.0678624,35100,35.1168292,-77.0813197,private,0,0,37,0,0,37,37,11,0,76,0,0,87,87,3.047374834
38060,33.1857653,-112.0678624,16860,35.0493612,-85.3611582,private,0,0,42,0,0,42,42,17,0,67,0,0,84,84,3.045504774
38060,33.1857653,-112.0678624,28940,36.0147907,-84.2067014,private,0,0,69,0,0,69,69,28,0,101,0,0,129,129,3.073555663
49740,32.7739424,-113.910905,10460,32.6155988,-105.7513079,private,0,13,0,0,13,0,13,0,16,23,0,16,23,39,3.017453886
31080,34.1087033,-118.1827533,18500,42.2667252,-77.3855253,private,0,0,25,0,0,25,25,11,0,39,0,0,50,50,3.02431077
31080,34.1087033,-118.1827533,36380,27.3855924,-80.8873884,private,0,0,53,0,0,53,53,0,0,77,0,0,77,77,3.041141303
31080,34.1087033,-118.1827533,19700,32.1845231,-107.7471911,private,0,0,60,0,0,60,60,11,0,81,0,0,92,92,3.050491599
41860,37.7737185,-122.2744317,33540,47.0272632,-113.8926911,private,0,0,21,0,0,21,21,0,0,50,0,0,50,50,3.02431077
34580,48.4932917,-121.8157703,21340,31.527394,-105.5213326,private,0,0,15,0,0,15,15,11,0,28,0,0,39,39,3.017453886
43220,47.3541257,-123.1738498,41620,40.5728869,-112.9532527,private,0,0,21,0,0,21,21,11,0,28,0,0,39,39,3.017453886
43220,47.3541257,-123.1738498,25840,45.5446021,-119.0761905,private,18,0,19,0,0,37,37,16,0,23,0,0,39,39,3.017453886
14460,42.517606,-71.0219925,23540,29.4807065,-82.6274667,private,0,0,38,0,0,38,38,0,0,30,0,0,30,30,3.011843708
37980,39.8949576,-75.3119824,39100,41.5752737,-74.0338729,private,14,0,61,0,0,75,75,0,0,83,0,0,83,83,3.044881421
37980,39.8949576,-75.3119824,33340,43.0176601,-87.4815541,private,0,0,38,0,0,38,38,0,0,47,0,0,47,47,3.022440711
33460,45.096664,-93.275361,17140,39.0998213,-84.4804072,private,0,0,65,0,0,65,65,0,0,75,0,0,75,75,3.039894597
33460,45.096664,-93.275361,40700,43.2863277,-123.154476,private,0,0,54,0,0,54,54,0,0,56,0,0,56,56,3.028050888
26420,29.7495926,-95.3536422,46520,21.5800225,-158.1234063,private,12,0,41,0,0,53,53,0,0,17,0,0,17,17,3.003740118
20900,29.2784805,-96.2296745,25060,30.4801526,-88.9992972,private,12,0,26,0,0,38,38,17,0,19,0,0,36,36,3.015583827
20900,29.2784805,-96.2296745,28140,38.9318494,-94.4438241,private,12,0,62,0,0,74,74,0,0,40,0,0,40,40,3.018077239
38060,33.1857653,-112.0678624,24020,43.4404503,-73.6367573,private,0,22,16,0,22,16,38,0,21,0,0,21,0,21,3.006233531
42660,47.4905993,-121.833996,25740,46.8113536,-112.2840307,private,11,0,56,0,0,67,67,12,0,45,0,0,57,57,3.028674241
42660,47.4905993,-121.833996,39820,40.7605142,-122.0435556,private,0,0,57,0,0,57,57,0,0,68,0,0,68,68,3.035531125
42660,47.4905993,-121.833996,41500,36.240107,-121.3155723,private,0,0,55,0,0,55,55,0,0,59,0,0,59,59,3.029920947
34580,48.4932917,-121.8157703,15980,26.5590348,-81.8919943,private,17,0,21,0,0,38,38,19,0,18,0,0,37,37,3.01620718
34580,48.4932917,-121.8157703,46380,39.4323876,-123.4428811,private,13,0,25,0,0,38,38,0,0,32,0,0,32,32,3.013090415
14460,42.517606,-71.0219925,45060,43.0065163,-76.1961336,private,0,0,53,0,0,53,53,0,0,93,0,0,93,93,3.051114952
35620,40.77493,-73.873758,36300,44.4881125,-75.074311,private,0,0,44,0,0,44,44,0,12,103,0,12,103,115,3.06482872
35620,40.77493,-73.873758,36420,35.4309676,-97.5069659,private,0,0,46,0,0,46,46,0,0,112,0,0,112,112,3.06295866
37980,39.8949576,-75.3119824,15540,44.6891168,-73.0411707,private,0,0,20,0,0,20,20,0,0,50,0,0,50,50,3.02431077
37980,39.8949576,-75.3119824,16540,39.9267722,-77.7245208,private,0,0,51,0,0,51,51,0,0,50,0,0,50,50,3.02431077
37980,39.8949576,-75.3119824,15680,38.2202894,-76.5303837,private,0,0,27,0,0,27,27,0,0,52,0,0,52,52,3.025557476
12060,33.693728,-84.3999113,33700,37.5623162,-121.0028311,private,0,0,33,0,0,33,33,15,0,37,0,0,52,52,3.025557476
33100,26.1018281,-80.4787552,21340,31.527394,-105.5213326,private,12,0,53,0,0,65,65,15,0,59,0,0,74,74,3.039271244
16980,41.8235214,-87.8282967,27140,32.4282801,-90.2023875,private,0,0,73,0,0,73,73,0,0,107,0,0,107,107,3.059841895
20900,29.2784805,-96.2296745,37860,30.6554013,-87.1618275,private,0,0,37,0,0,37,37,16,0,22,0,0,38,38,3.016830533
20900,29.2784805,-96.2296745,22220,36.1163935,-94.0795449,private,13,0,21,0,0,34,34,18,0,20,0,0,38,38,3.016830533
20900,29.2784805,-96.2296745,38900,45.6006221,-122.484378,private,0,0,40,0,0,40,40,16,0,39,0,0,55,55,3.027427535
38060,33.1857653,-112.0678624,48900,34.4260331,-77.889634,private,15,0,39,0,0,54,54,14,0,47,0,0,61,61,3.031167654
38060,33.1857653,-112.0678624,17020,39.6659588,-121.6019188,private,0,0,49,0,0,49,49,0,0,82,0,0,82,82,3.044258068
49740,32.7739424,-113.910905,25460,36.0878092,-93.1620533,private,0,0,0,0,0,0,0,12,0,26,0,0,38,38,3.016830533
31080,34.1087033,-118.1827533,38860,43.6514172,-70.4183755,private,0,0,48,0,0,48,48,0,0,72,0,0,72,72,3.038024537
42660,47.4905993,-121.833996,31140,38.3058381,-85.6816455,private,0,0,48,0,0,48,48,0,0,61,0,0,61,61,3.031167654
34580,48.4932917,-121.8157703,37260,29.5938964,-81.7320389,private,16,0,17,0,0,33,33,11,0,27,0,0,38,38,3.016830533
34580,48.4932917,-121.8157703,45300,28.1259071,-82.4652858,private,13,12,49,0,12,62,74,13,11,99,0,11,112,123,3.069815544
34580,48.4932917,-121.8157703,23620,33.6391964,-97.2103433,private,0,0,0,0,0,0,0,14,0,24,0,0,38,38,3.016830533
34580,48.4932917,-121.8157703,17020,39.6659588,-121.6019188,private,0,0,22,0,0,22,22,0,0,38,0,0,38,38,3.016830533
43220,47.3541257,-123.1738498,33100,26.1018281,-80.4787552,private,0,0,55,0,0,55,55,12,0,50,0,0,62,62,3.031791007
33460,45.096664,-93.275361,39150,34.631071,-112.5772247,private,15,11,22,0,11,37,48,12,0,12,0,0,24,24,3.00810359
19100,32.8491708,-96.9704894,17900,34.0775845,-81.0378453,private,11,0,66,0,0,77,77,0,0,54,0,0,54,54,3.026804182
20900,29.2784805,-96.2296745,24860,34.6837085,-82.4134227,private,14,0,23,0,0,37,37,17,0,13,0,0,30,30,3.011843708
20900,29.2784805,-96.2296745,34580,48.4932917,-121.8157703,private,17,0,20,0,0,37,37,0,0,15,0,0,15,15,3.002493412
20900,29.2784805,-96.2296745,43220,47.3541257,-123.1738498,private,11,0,26,0,0,37,37,0,0,17,0,0,17,17,3.003740118
38060,33.1857653,-112.0678624,36100,29.2028047,-82.0431004,private,11,0,52,0,0,63,63,13,0,65,0,0,78,78,3.041764656
38060,33.1857653,-112.0678624,48780,48.3557649,-103.5013332,private,0,44,15,0,44,15,59,13,13,0,0,13,13,26,3.009350296
49740,32.7739424,-113.910905,47980,44.8524086,-97.1770994,private,12,25,0,0,25,12,37,0,25,0,0,25,0,25,3.008726943
31080,34.1087033,-118.1827533,40380,43.148038,-77.5232575,private,0,0,49,0,0,49,49,0,0,70,0,0,70,70,3.036777831
42660,47.4905993,-121.833996,17900,34.0775845,-81.0378453,private,19,0,18,0,0,37,37,19,0,23,0,0,42,42,3.019323945
14460,42.517606,-71.0219925,10900,40.7893392,-75.398158,private,0,0,23,0,0,23,23,0,0,62,0,0,62,62,3.031791007
14460,42.517606,-71.0219925,46520,21.5800225,-158.1234063,private,14,0,22,0,0,36,36,0,0,37,0,0,37,37,3.01620718
35620,40.77493,-73.873758,45220,30.3864255,-84.2804096,private,0,0,33,0,0,33,33,0,0,70,0,0,70,70,3.036777831
37980,39.8949576,-75.3119824,10740,35.1234965,-106.4583918,private,0,0,30,0,0,30,30,0,0,48,0,0,48,48,3.023064064
47900,38.7982054,-77.4868816,13820,33.4025986,-86.7295151,private,0,0,19,0,0,19,19,0,0,37,0,0,37,37,3.01620718
12060,33.693728,-84.3999113,31540,43.0842941,-89.5971796,private,0,0,70,0,0,70,70,0,0,95,0,0,95,95,3.052361658
33100,26.1018281,-80.4787552,43900,34.9332708,-81.9910522,private,0,0,16,0,0,16,16,0,0,53,0,0,53,53,3.026180829
16980,41.8235214,-87.8282967,10380,18.3569648,-67.0078951,private,0,0,55,0,0,55,55,0,0,60,0,0,60,60,3.030544301
16980,41.8235214,-87.8282967,30700,40.8174581,-96.8687434,private,0,0,34,0,0,34,34,0,0,52,0,0,52,52,3.025557476
19100,32.8491708,-96.9704894,10460,32.6155988,-105.7513079,private,0,20,0,0,20,0,20,11,26,0,0,26,11,37,3.01620718
26420,29.7495926,-95.3536422,47260,36.8044077,-76.4495261,private,0,0,84,0,0,84,84,0,0,107,0,0,107,107,3.059841895
26420,29.7495926,-95.3536422,23060,41.1131166,-85.2177047,private,0,0,14,0,0,14,14,0,0,37,0,0,37,37,3.01620718
26420,29.7495926,-95.3536422,31540,43.0842941,-89.5971796,private,0,0,0,0,0,0,0,11,0,49,0,0,60,60,3.030544301
49740,32.7739424,-113.910905,26340,47.6819737,-88.1487965,private,0,16,0,0,16,0,16,0,20,17,0,20,17,37,3.01620718
31080,34.1087033,-118.1827533,47260,36.8044077,-76.4495261,private,0,0,96,0,0,96,96,0,0,141,0,0,141,141,3.081035899
42660,47.4905993,-121.833996,39300,41.7068313,-71.2866369,private,0,0,75,0,0,75,75,12,0,77,0,0,89,89,3.04862154
42660,47.4905993,-121.833996,39340,39.872067,-112.3590592,private,11,0,19,0,0,30,30,17,0,20,0,0,37,37,3.01620718
34580,48.4932917,-121.8157703,39660,44.3154852,-102.7683833,private,13,0,12,0,0,25,25,12,0,25,0,0,37,37,3.01620718
43220,47.3541257,-123.1738498,24860,34.6837085,-82.4134227,private,0,0,19,0,0,19,19,13,0,24,0,0,37,37,3.01620718
14460,42.517606,-71.0219925,28140,38.9318494,-94.4438241,private,0,0,70,0,0,70,70,0,0,63,0,0,63,63,3.03241436
37980,39.8949576,-75.3119824,44140,42.3648332,-72.6194063,private,0,0,47,0,0,47,47,0,0,64,0,0,64,64,3.033037713
37980,39.8949576,-75.3119824,45060,43.0065163,-76.1961336,private,0,0,66,0,0,66,66,0,0,65,0,0,65,65,3.033661066
12060,33.693728,-84.3999113,39300,41.7068313,-71.2866369,private,0,0,156,0,0,156,156,11,0,108,0,0,119,119,3.067322132
12060,33.693728,-84.3999113,45940,40.2825026,-74.703724,private,12,0,72,0,0,84,84,0,0,56,0,0,56,56,3.028050888
33100,26.1018281,-80.4787552,19430,39.8288538,-84.1418129,private,16,0,31,0,0,47,47,0,0,48,0,0,48,48,3.023064064
33100,26.1018281,-80.4787552,43220,47.3541257,-123.1738498,private,13,0,35,0,0,48,48,0,0,35,0,0,35,35,3.014960474
33460,45.096664,-93.275361,19820,42.7218478,-83.2008463,private,0,0,126,0,0,126,126,13,0,129,0,0,142,142,3.081659253
19100,32.8491708,-96.9704894,42460,34.764114,-85.9800556,private,12,0,24,0,0,36,36,0,0,25,0,0,25,25,3.008726943
26420,29.7495926,-95.3536422,14860,41.2274128,-73.3670614,private,12,0,24,0,0,36,36,0,0,23,0,0,23,23,3.007480237
38060,33.1857653,-112.0678624,15540,44.6891168,-73.0411707,private,0,22,31,0,22,31,53,0,14,29,0,14,29,43,3.019947298
38060,33.1857653,-112.0678624,25420,40.335915,-77.0504897,private,0,11,52,0,11,52,63,0,0,52,0,0,52,52,3.025557476
38060,33.1857653,-112.0678624,47260,36.8044077,-76.4495261,private,11,0,75,0,0,86,86,0,0,90,0,0,90,90,3.049244893
49740,32.7739424,-113.910905,25940,32.3867916,-80.8308775,private,21,0,15,0,0,36,36,15,0,16,0,0,31,31,3.012467061
42660,47.4905993,-121.833996,23420,36.7610058,-119.6550193,private,0,0,81,0,0,81,81,0,0,65,0,0,65,65,3.033661066
42660,47.4905993,-121.833996,25840,45.5446021,-119.0761905,private,0,0,67,0,0,67,67,0,0,67,0,0,67,67,3.034907772
43220,47.3541257,-123.1738498,12060,33.693728,-84.3999113,private,38,0,66,0,0,104,104,27,0,49,0,0,76,76,3.04051795
43220,47.3541257,-123.1738498,37100,34.3587415,-119.1331432,private,17,0,19,0,0,36,36,17,0,18,0,0,35,35,3.014960474
42660,47.4905993,-121.833996,36300,44.4881125,-75.074311,private,16,0,20,0,0,36,36,17,0,18,0,0,35,35,3.014960474
14460,42.517606,-71.0219925,32820,35.0244194,-89.8719712,private,0,0,26,0,0,26,26,0,0,36,0,0,36,36,3.015583827
35620,40.77493,-73.873758,41500,36.240107,-121.3155723,private,0,0,18,0,0,18,18,0,0,67,0,0,67,67,3.034907772
35620,40.77493,-73.873758,42020,35.3852242,-120.4475445,private,0,0,41,0,0,41,41,0,0,71,0,0,71,71,3.037401184
37980,39.8949576,-75.3119824,28660,31.2027301,-97.7896384,private,0,0,43,0,0,43,43,0,0,52,0,0,52,52,3.025557476
12060,33.693728,-84.3999113,35300,41.3497185,-72.9002033,private,0,0,105,0,0,105,105,0,0,147,0,0,147,147,3.084776018
33100,26.1018281,-80.4787552,25060,30.4801526,-88.9992972,private,0,0,37,0,0,37,37,16,0,34,0,0,50,50,3.02431077
33100,26.1018281,-80.4787552,40140,34.5384763,-116.1345414,private,24,0,111,0,0,135,135,0,0,141,0,0,141,141,3.081035899
19100,32.8491708,-96.9704894,26620,34.7832617,-86.7348706,private,0,0,28,0,0,28,28,11,0,36,0,0,47,47,3.022440711
19100,32.8491708,-96.9704894,39150,34.631071,-112.5772247,private,11,0,16,0,0,27,27,14,0,35,0,0,49,49,3.023687417
20900,29.2784805,-96.2296745,10740,35.1234965,-106.4583918,private,0,0,28,0,0,28,28,12,0,24,0,0,36,36,3.015583827
26420,29.7495926,-95.3536422,33380,32.7321522,-93.3398245,private,0,0,52,0,0,52,52,11,0,54,0,0,65,65,3.033661066
38060,33.1857653,-112.0678624,14860,41.2274128,-73.3670614,private,0,20,23,0,20,23,43,0,20,16,0,20,16,36,3.015583827
31080,34.1087033,-118.1827533,48900,34.4260331,-77.889634,private,0,0,50,0,0,50,50,0,0,75,0,0,75,75,3.039894597
41860,37.7737185,-122.2744317,38860,43.6514172,-70.4183755,private,0,0,35,0,0,35,35,0,0,68,0,0,68,68,3.035531125
41860,37.7737185,-122.2744317,16820,37.9490837,-78.5932062,private,0,0,21,0,0,21,21,0,0,49,0,0,49,49,3.023687417
41860,37.7737185,-122.2744317,27260,30.2365943,-81.7544462,private,0,0,59,0,0,59,59,0,0,98,0,0,98,98,3.054231717
42660,47.4905993,-121.833996,13940,43.2163568,-112.3992058,private,0,0,26,0,0,26,26,15,0,33,0,0,48,48,3.023064064
42660,47.4905993,-121.833996,35300,41.3497185,-72.9002033,private,14,0,32,0,0,46,46,0,0,71,0,0,71,71,3.037401184
42660,47.4905993,-121.833996,28020,42.2462657,-85.5328544,private,0,0,31,0,0,31,31,0,0,59,0,0,59,59,3.029920947
34580,48.4932917,-121.8157703,25740,46.8113536,-112.2840307,private,0,0,22,0,0,22,22,11,0,25,0,0,36,36,3.015583827
34580,48.4932917,-121.8157703,28660,31.2027301,-97.7896384,private,0,0,21,0,0,21,21,13,0,23,0,0,36,36,3.015583827
34580,48.4932917,-121.8157703,41940,36.9084718,-121.3713721,private,0,0,42,0,0,42,42,0,11,42,0,11,42,53,3.026180829
43220,47.3541257,-123.1738498,35100,35.1168292,-77.0813197,private,17,0,0,0,0,17,17,16,0,20,0,0,36,36,3.015583827
43220,47.3541257,-123.1738498,30020,34.5291104,-98.4309172,private,14,0,16,0,0,30,30,16,0,20,0,0,36,36,3.015583827
47900,38.7982054,-77.4868816,46520,21.5800225,-158.1234063,private,0,0,35,0,0,35,35,0,0,28,0,0,28,28,3.010597002
12060,33.693728,-84.3999113,18260,36.2772512,-85.4685013,private,15,0,57,0,0,72,72,0,0,42,0,0,42,42,3.019323945
33460,45.096664,-93.275361,46520,21.5800225,-158.1234063,private,14,0,32,0,0,46,46,0,0,28,0,0,28,28,3.010597002
19100,32.8491708,-96.9704894,29340,29.9787547,-93.2532434,private,0,0,47,0,0,47,47,0,0,44,0,0,44,44,3.020570651
26420,29.7495926,-95.3536422,15380,43.0443711,-78.7773351,private,0,0,49,0,0,49,49,0,0,32,0,0,32,32,3.013090415
26420,29.7495926,-95.3536422,29940,38.8964168,-95.2909475,private,11,0,24,0,0,35,35,0,0,20,0,0,20,20,3.005610178
20900,29.2784805,-96.2296745,41180,38.7402108,-90.3458253,private,26,0,33,0,0,59,59,0,0,50,0,0,50,50,3.02431077
38060,33.1857653,-112.0678624,32820,35.0244194,-89.8719712,private,27,0,42,0,0,69,69,0,0,57,0,0,57,57,3.028674241
38060,33.1857653,-112.0678624,19860,46.9125835,-102.9884867,private,12,25,11,0,25,23,48,11,22,0,0,22,11,33,3.013713768
49740,32.7739424,-113.910905,15380,43.0443711,-78.7773351,private,0,23,25,0,23,25,48,0,18,28,0,18,28,46,3.021817358
49740,32.7739424,-113.910905,25420,40.335915,-77.0504897,private,14,0,21,0,0,35,35,0,0,15,0,0,15,15,3.002493412
49740,32.7739424,-113.910905,15680,38.2202894,-76.5303837,private,14,0,21,0,0,35,35,11,0,0,0,0,11,11,3
49740,32.7739424,-113.910905,16580,40.1029885,-88.3185039,private,13,11,11,0,11,24,35,0,11,11,0,11,11,22,3.006856884
42660,47.4905993,-121.833996,29940,38.8964168,-95.2909475,private,25,0,55,0,0,80,80,13,0,51,0,0,64,64,3.033037713
14460,42.517606,-71.0219925,21580,36.5096687,-106.6939829,private,0,0,19,0,0,19,19,0,0,35,0,0,35,35,3.014960474
14460,42.517606,-71.0219925,39900,40.5007953,-119.7311608,private,0,0,0,0,0,0,0,0,0,35,0,0,35,35,3.014960474
35620,40.77493,-73.873758,15680,38.2202894,-76.5303837,private,0,0,76,0,0,76,76,0,0,99,0,0,99,99,3.05485507
35620,40.77493,-73.873758,31340,37.3649258,-79.2166894,private,0,0,0,0,0,0,0,0,0,75,0,0,75,75,3.039894597
37980,39.8949576,-75.3119824,37860,30.6554013,-87.1618275,private,0,0,30,0,0,30,30,11,0,50,0,0,61,61,3.031167654
47900,38.7982054,-77.4868816,30460,38.1028763,-84.4385451,private,0,0,20,0,0,20,20,0,0,35,0,0,35,35,3.014960474
33100,26.1018281,-80.4787552,22420,43.0210768,-83.7063718,private,0,0,47,0,0,47,47,0,0,61,0,0,61,61,3.031167654
33460,45.096664,-93.275361,10540,44.4888982,-122.5372084,private,0,0,13,0,0,13,13,0,0,47,0,0,47,47,3.022440711
16980,41.8235214,-87.8282967,12940,30.5187808,-91.1255901,private,0,0,17,0,0,17,17,0,0,35,0,0,35,35,3.014960474
20900,29.2784805,-96.2296745,15980,26.5590348,-81.8919943,private,0,0,17,0,0,17,17,15,0,20,0,0,35,35,3.014960474
38060,33.1857653,-112.0678624,39100,41.5752737,-74.0338729,private,0,0,46,0,0,46,46,0,12,56,0,12,56,68,3.035531125
38060,33.1857653,-112.0678624,17860,38.9864864,-92.5851888,private,0,0,38,0,0,38,38,13,0,33,0,0,46,46,3.021817358
49740,32.7739424,-113.910905,47260,36.8044077,-76.4495261,private,27,0,53,0,0,80,80,27,0,41,0,0,68,68,3.035531125
49740,32.7739424,-113.910905,37900,40.7088872,-89.6974658,private,12,21,0,0,21,12,33,14,21,0,0,21,14,35,3.014960474
49740,32.7739424,-113.910905,32580,26.3963839,-98.18099,private,0,0,12,0,0,12,12,13,0,22,0,0,35,35,3.014960474
31080,34.1087033,-118.1827533,16820,37.9490837,-78.5932062,private,0,0,26,0,0,26,26,0,0,49,0,0,49,49,3.023687417
42660,47.4905993,-121.833996,29460,27.9536488,-81.6935337,private,0,0,43,0,0,43,43,15,0,57,0,0,72,72,3.038024537
42660,47.4905993,-121.833996,38860,43.6514172,-70.4183755,private,0,0,48,0,0,48,48,0,0,73,0,0,73,73,3.038647891
14460,42.517606,-71.0219925,40140,34.5384763,-116.1345414,private,0,0,81,0,0,81,81,0,0,75,0,0,75,75,3.039894597
16980,41.8235214,-87.8282967,41980,18.2944526,-66.0368437,private,0,0,67,0,0,67,67,0,0,60,0,0,60,60,3.030544301
16980,41.8235214,-87.8282967,48620,37.637896,-97.2462875,private,0,0,56,0,0,56,56,0,0,40,0,0,40,40,3.018077239
38060,33.1857653,-112.0678624,25840,45.5446021,-119.0761905,private,11,12,22,0,12,33,45,0,0,28,0,0,28,28,3.010597002
49740,32.7739424,-113.910905,36300,44.4881125,-75.074311,private,0,19,15,0,19,15,34,0,13,19,0,13,19,32,3.013090415
31080,34.1087033,-118.1827533,45940,40.2825026,-74.703724,private,0,0,47,0,0,47,47,0,0,47,0,0,47,47,3.022440711
41860,37.7737185,-122.2744317,17660,47.6759658,-116.6959222,private,11,0,23,0,0,34,34,14,0,46,0,0,60,60,3.030544301
41860,37.7737185,-122.2744317,26900,39.74867,-86.2123823,private,0,0,64,0,0,64,64,0,0,91,0,0,91,91,3.049868246
35620,40.77493,-73.873758,40220,37.2862262,-79.9469346,private,0,0,44,0,0,44,44,0,0,81,0,0,81,81,3.043634715
47900,38.7982054,-77.4868816,32820,35.0244194,-89.8719712,private,0,0,26,0,0,26,26,0,0,34,0,0,34,34,3.014337121
12060,33.693728,-84.3999113,10420,41.1466395,-81.3501104,private,13,0,56,0,0,69,69,0,0,93,0,0,93,93,3.051114952
33100,26.1018281,-80.4787552,49180,36.0788515,-80.3450642,private,11,0,63,0,0,74,74,11,0,56,0,0,67,67,3.034907772
33100,26.1018281,-80.4787552,23380,41.3553193,-83.1427763,private,0,18,0,0,18,0,18,15,19,0,0,19,15,34,3.014337121
33460,45.096664,-93.275361,32380,43.2137325,-93.2743388,private,0,0,56,0,0,56,56,0,0,77,0,0,77,77,3.041141303
16980,41.8235214,-87.8282967,32280,36.3035963,-88.7211938,private,0,0,29,0,0,29,29,12,0,47,0,0,59,59,3.029920947
49740,32.7739424,-113.910905,11700,35.5956693,-82.6816145,private,0,13,0,0,13,0,13,0,11,23,0,11,23,34,3.014337121
31080,34.1087033,-118.1827533,37260,29.5938964,-81.7320389,private,0,0,58,0,0,58,58,11,0,78,0,0,89,89,3.04862154
31080,34.1087033,-118.1827533,46340,32.3770156,-95.2700409,private,0,0,29,0,0,29,29,11,0,36,0,0,47,47,3.022440711
41860,37.7737185,-122.2744317,44140,42.3648332,-72.6194063,private,0,0,32,0,0,32,32,0,0,50,0,0,50,50,3.02431077
41860,37.7737185,-122.2744317,15540,44.6891168,-73.0411707,private,0,0,23,0,0,23,23,0,0,34,0,0,34,34,3.014337121
41860,37.7737185,-122.2744317,24660,36.0252039,-79.7926333,private,0,0,11,0,0,11,11,11,0,67,0,0,78,78,3.041764656
41860,37.7737185,-122.2744317,11700,35.5956693,-82.6816145,private,0,0,22,0,0,22,22,0,0,86,0,0,86,86,3.04675148
41860,37.7737185,-122.2744317,37260,29.5938964,-81.7320389,private,0,0,12,0,0,12,12,0,0,50,0,0,50,50,3.02431077
42660,47.4905993,-121.833996,14860,41.2274128,-73.3670614,private,0,0,29,0,0,29,29,0,0,53,0,0,53,53,3.026180829
43220,47.3541257,-123.1738498,25740,46.8113536,-112.2840307,private,15,0,12,0,0,27,27,11,0,23,0,0,34,34,3.014337121
43220,47.3541257,-123.1738498,39340,39.872067,-112.3590592,private,0,0,12,0,0,12,12,17,0,17,0,0,34,34,3.014337121
47900,38.7982054,-77.4868816,31340,37.3649258,-79.2166894,private,0,0,33,0,0,33,33,0,0,30,0,0,30,30,3.011843708
33100,26.1018281,-80.4787552,29620,42.7712334,-84.4960294,private,0,15,62,0,15,62,77,0,0,24,0,0,24,24,3.00810359
33100,26.1018281,-80.4787552,23780,38.0254528,-100.9706954,private,0,0,60,0,0,60,60,0,0,23,0,0,23,23,3.007480237
33460,45.096664,-93.275361,31140,38.3058381,-85.6816455,private,0,0,46,0,0,46,46,0,0,53,0,0,53,53,3.026180829
19100,32.8491708,-96.9704894,24540,40.555961,-104.383666,private,13,0,20,0,0,33,33,0,0,20,0,0,20,20,3.005610178
26420,29.7495926,-95.3536422,16100,32.4578347,-104.3064338,private,25,0,37,0,0,62,62,0,0,15,0,0,15,15,3.002493412
20900,29.2784805,-96.2296745,40140,34.5384763,-116.1345414,private,12,0,33,0,0,45,45,0,0,26,0,0,26,26,3.009350296
38060,33.1857653,-112.0678624,45060,43.0065163,-76.1961336,private,0,26,31,0,26,31,57,0,17,64,0,17,64,81,3.043634715
49740,32.7739424,-113.910905,40380,43.148038,-77.5232575,private,0,35,27,0,35,27,62,12,25,28,0,25,40,65,3.033661066
49740,32.7739424,-113.910905,27220,44.048662,-110.426087,private,0,33,0,0,33,0,33,0,21,0,0,21,0,21,3.006233531
41860,37.7737185,-122.2744317,44060,48.091618,-117.663472,private,0,0,55,0,0,55,55,0,0,73,0,0,73,73,3.038647891
35620,40.77493,-73.873758,19430,39.8288538,-84.1418129,private,0,0,22,0,0,22,22,0,0,107,0,0,107,107,3.059841895
37980,39.8949576,-75.3119824,31540,43.0842941,-89.5971796,private,0,0,50,0,0,50,50,0,0,33,0,0,33,33,3.013713768
47900,38.7982054,-77.4868816,10900,40.7893392,-75.398158,private,0,0,12,0,0,12,12,0,0,46,0,0,46,46,3.021817358
47900,38.7982054,-77.4868816,23540,29.4807065,-82.6274667,private,0,0,20,0,0,20,20,0,0,33,0,0,33,33,3.013713768
47900,38.7982054,-77.4868816,40140,34.5384763,-116.1345414,private,0,0,57,0,0,57,57,0,0,83,0,0,83,83,3.044881421
47900,38.7982054,-77.4868816,43220,47.3541257,-123.1738498,private,0,0,24,0,0,24,24,11,0,22,0,0,33,33,3.013713768
16980,41.8235214,-87.8282967,38860,43.6514172,-70.4183755,private,0,0,43,0,0,43,43,0,0,49,0,0,49,49,3.023687417
16980,41.8235214,-87.8282967,37100,34.3587415,-119.1331432,private,0,0,52,0,0,52,52,0,0,58,0,0,58,58,3.029297594
16980,41.8235214,-87.8282967,42200,34.5370572,-120.0399729,private,0,0,42,0,0,42,42,0,0,44,0,0,44,44,3.020570651
19100,32.8491708,-96.9704894,24340,43.0375977,-85.7781669,private,0,0,31,0,0,31,31,13,0,20,0,0,33,33,3.013713768
19100,32.8491708,-96.9704894,44060,48.091618,-117.663472,private,0,0,34,0,0,34,34,0,0,58,0,0,58,58,3.029297594
26420,29.7495926,-95.3536422,48900,34.4260331,-77.889634,private,0,0,37,0,0,37,37,0,0,45,0,0,45,45,3.021194004
20900,29.2784805,-96.2296745,37260,29.5938964,-81.7320389,private,0,0,12,0,0,12,12,11,0,22,0,0,33,33,3.013713768
38060,33.1857653,-112.0678624,29060,43.5191091,-71.4253661,private,0,24,0,0,24,0,24,0,22,11,0,22,11,33,3.013713768
38060,33.1857653,-112.0678624,15140,35.5866782,-89.2826913,private,0,0,29,0,0,29,29,13,0,31,0,0,44,44,3.020570651
49740,32.7739424,-113.910905,17860,38.9864864,-92.5851888,private,15,0,17,0,0,32,32,11,0,22,0,0,33,33,3.013713768
31080,34.1087033,-118.1827533,13820,33.4025986,-86.7295151,private,0,0,21,0,0,21,21,0,0,33,0,0,33,33,3.013713768
31080,34.1087033,-118.1827533,39340,39.872067,-112.3590592,private,12,0,63,0,0,75,75,24,0,70,0,0,94,94,3.051738305
41860,37.7737185,-122.2744317,40380,43.148038,-77.5232575,private,0,0,19,0,0,19,19,0,0,33,0,0,33,33,3.013713768
42660,47.4905993,-121.833996,46140,36.2544287,-96.1773294,private,0,0,76,0,0,76,76,12,0,75,0,0,87,87,3.047374834
14460,42.517606,-71.0219925,41980,18.2944526,-66.0368437,private,0,0,54,0,0,54,54,0,0,52,0,0,52,52,3.025557476
37980,39.8949576,-75.3119824,23540,29.4807065,-82.6274667,private,0,0,44,0,0,44,44,0,0,43,0,0,43,43,3.019947298
37980,39.8949576,-75.3119824,40140,34.5384763,-116.1345414,private,0,0,86,0,0,86,86,0,0,77,0,0,77,77,3.041141303
37980,39.8949576,-75.3119824,40900,38.7896779,-121.0057504,private,0,0,63,0,0,63,63,0,0,72,0,0,72,72,3.038024537
12060,33.693728,-84.3999113,44260,33.5146172,-89.0775079,private,11,0,79,0,0,90,90,0,0,63,0,0,63,63,3.03241436
33100,26.1018281,-80.4787552,39740,40.4139565,-75.9268598,private,0,0,49,0,0,49,49,0,0,29,0,0,29,29,3.011220355
16980,41.8235214,-87.8282967,23540,29.4807065,-82.6274667,private,0,0,43,0,0,43,43,0,0,58,0,0,58,58,3.029297594
19100,32.8491708,-96.9704894,31540,43.0842941,-89.5971796,private,11,0,47,0,0,58,58,0,0,63,0,0,63,63,3.03241436
38060,33.1857653,-112.0678624,23700,35.5838784,-108.2532659,private,14,0,33,0,0,47,47,0,0,46,0,0,46,46,3.021817358
49740,32.7739424,-113.910905,36100,29.2028047,-82.0431004,private,16,0,16,0,0,32,32,16,0,12,0,0,28,28,3.010597002
31080,34.1087033,-118.1827533,28420,46.3639636,-119.2540459,private,0,0,107,0,0,107,107,0,0,61,0,0,61,61,3.031167654
43220,47.3541257,-123.1738498,11460,42.2522168,-83.8434233,private,14,0,18,0,0,32,32,0,0,18,0,0,18,18,3.004363472
42660,47.4905993,-121.833996,47260,36.8044077,-76.4495261,private,31,0,94,0,0,125,125,11,0,94,0,0,105,105,3.058595189
14460,42.517606,-71.0219925,29620,42.7712334,-84.4960294,private,0,0,13,0,0,13,13,0,0,44,0,0,44,44,3.020570651
35620,40.77493,-73.873758,44980,40.8515244,-76.709877,private,0,0,23,0,0,23,23,0,0,60,0,0,60,60,3.030544301
35620,40.77493,-73.873758,21020,36.1968134,-76.3426012,private,0,0,17,0,0,17,17,0,0,58,0,0,58,58,3.029297594
47900,38.7982054,-77.4868816,35100,35.1168292,-77.0813197,private,0,0,24,0,0,24,24,0,0,32,0,0,32,32,3.013090415
47900,38.7982054,-77.4868816,42340,32.1091533,-81.2731066,private,0,0,0,0,0,0,0,0,0,32,0,0,32,32,3.013090415
47900,38.7982054,-77.4868816,28940,36.0147907,-84.2067014,private,0,0,15,0,0,15,15,0,0,46,0,0,46,46,3.021817358
16980,41.8235214,-87.8282967,15540,44.6891168,-73.0411707,private,0,0,25,0,0,25,25,0,0,32,0,0,32,32,3.013090415
16980,41.8235214,-87.8282967,42340,32.1091533,-81.2731066,private,0,0,22,0,0,22,22,0,0,57,0,0,57,57,3.028674241
16980,41.8235214,-87.8282967,22620,35.0228383,-90.7515053,private,0,0,0,0,0,0,0,0,0,32,0,0,32,32,3.013090415
16980,41.8235214,-87.8282967,41500,36.240107,-121.3155723,private,0,0,12,0,0,12,12,0,0,43,0,0,43,43,3.019947298
19100,32.8491708,-96.9704894,35100,35.1168292,-77.0813197,private,0,0,30,0,0,30,30,0,0,44,0,0,44,44,3.020570651
19100,32.8491708,-96.9704894,25620,31.2737661,-89.3006335,private,0,0,40,0,0,40,40,11,0,36,0,0,47,47,3.022440711
19100,32.8491708,-96.9704894,39900,40.5007953,-119.7311608,private,0,0,44,0,0,44,44,14,0,36,0,0,50,50,3.02431077
26420,29.7495926,-95.3536422,17900,34.0775845,-81.0378453,private,0,0,32,0,0,32,32,0,0,56,0,0,56,56,3.028050888
26420,29.7495926,-95.3536422,15140,35.5866782,-89.2826913,private,0,0,31,0,0,31,31,11,0,43,0,0,54,54,3.026804182
38060,33.1857653,-112.0678624,19430,39.8288538,-84.1418129,private,0,0,78,0,0,78,78,0,0,94,0,0,94,94,3.051738305
49740,32.7739424,-113.910905,17140,39.0998213,-84.4804072,private,0,0,23,0,0,23,23,11,0,64,0,0,75,75,3.039894597
31080,34.1087033,-118.1827533,44140,42.3648332,-72.6194063,private,0,0,41,0,0,41,41,0,0,32,0,0,32,32,3.013090415
31080,34.1087033,-118.1827533,12700,41.7990145,-70.2118803,private,0,0,38,0,0,38,38,0,0,58,0,0,58,58,3.029297594
31080,34.1087033,-118.1827533,28740,41.9472124,-74.2654582,private,0,0,17,0,0,17,17,0,0,32,0,0,32,32,3.013090415
41860,37.7737185,-122.2744317,30100,43.7857256,-72.1591415,private,0,0,0,0,0,0,0,0,0,50,0,0,50,50,3.02431077
43220,47.3541257,-123.1738498,28940,36.0147907,-84.2067014,private,0,0,27,0,0,27,27,11,0,36,0,0,47,47,3.022440711
43220,47.3541257,-123.1738498,39660,44.3154852,-102.7683833,private,11,0,17,0,0,28,28,20,0,12,0,0,32,32,3.013090415
47900,38.7982054,-77.4868816,17900,34.0775845,-81.0378453,private,0,0,43,0,0,43,43,0,0,61,0,0,61,61,3.031167654
47900,38.7982054,-77.4868816,15980,26.5590348,-81.8919943,private,0,0,31,0,0,31,31,0,0,31,0,0,31,31,3.012467061
12060,33.693728,-84.3999113,48580,42.6681095,-88.5417306,private,11,0,31,0,0,42,42,12,0,26,0,0,38,38,3.016830533
33100,26.1018281,-80.4787552,36540,41.2904587,-95.9999701,private,0,0,50,0,0,50,50,0,0,48,0,0,48,48,3.023064064
33460,45.096664,-93.275361,35380,29.805532,-89.7013821,private,0,0,47,0,0,47,47,0,0,34,0,0,34,34,3.014337121
19100,32.8491708,-96.9704894,24660,36.0252039,-79.7926333,private,26,0,51,0,0,77,77,0,0,82,0,0,82,82,3.044258068
19100,32.8491708,-96.9704894,47020,28.7314546,-97.1969934,private,0,0,62,0,0,62,62,0,0,61,0,0,61,61,3.031167654
20900,29.2784805,-96.2296745,14460,42.517606,-71.0219925,private,13,0,33,0,0,46,46,0,0,15,0,0,15,15,3.002493412
20900,29.2784805,-96.2296745,11460,42.2522168,-83.8434233,private,15,0,16,0,0,31,31,0,0,16,0,0,16,16,3.003116765
20900,29.2784805,-96.2296745,46060,32.1280427,-111.7836574,private,11,0,33,0,0,44,44,12,0,12,0,0,24,24,3.00810359
38060,33.1857653,-112.0678624,46340,32.3770156,-95.2700409,private,11,0,47,0,0,58,58,0,0,37,0,0,37,37,3.01620718
49740,32.7739424,-113.910905,46520,21.5800225,-158.1234063,private,11,0,20,0,0,31,31,12,0,15,0,0,27,27,3.009973649
34580,48.4932917,-121.8157703,22180,35.1559863,-78.93185,private,16,0,15,0,0,31,31,0,0,23,0,0,23,23,3.007480237
14460,42.517606,-71.0219925,25420,40.335915,-77.0504897,private,0,0,26,0,0,26,26,0,0,45,0,0,45,45,3.021194004
14460,42.517606,-71.0219925,49180,36.0788515,-80.3450642,private,0,0,16,0,0,16,16,0,0,31,0,0,31,31,3.012467061
14460,42.517606,-71.0219925,46380,39.4323876,-123.4428811,private,0,0,16,0,0,16,16,0,0,31,0,0,31,31,3.012467061
35620,40.77493,-73.873758,23620,33.6391964,-97.2103433,private,0,0,37,0,0,37,37,0,0,52,0,0,52,52,3.025557476
35620,40.77493,-73.873758,25980,31.7787881,-81.5764801,private,0,0,39,0,0,39,39,11,0,66,0,0,77,77,3.041141303
35620,40.77493,-73.873758,24340,43.0375977,-85.7781669,private,0,0,33,0,0,33,33,0,0,81,0,0,81,81,3.043634715
35620,40.77493,-73.873758,29940,38.8964168,-95.2909475,private,0,0,12,0,0,12,12,0,0,59,0,0,59,59,3.029920947
47900,38.7982054,-77.4868816,41980,18.2944526,-66.0368437,private,0,0,26,0,0,26,26,0,0,31,0,0,31,31,3.012467061
47900,38.7982054,-77.4868816,15380,43.0443711,-78.7773351,private,0,0,27,0,0,27,27,0,0,56,0,0,56,56,3.028050888
33100,26.1018281,-80.4787552,33660,30.9715095,-88.20787,private,12,0,61,0,0,73,73,11,0,69,0,0,80,80,3.043011362
16980,41.8235214,-87.8282967,14260,43.0066485,-116.1419089,private,11,0,49,0,0,60,60,11,0,94,0,0,105,105,3.058595189
19100,32.8491708,-96.9704894,35300,41.3497185,-72.9002033,private,0,0,41,0,0,41,41,0,0,49,0,0,49,49,3.023687417
19100,32.8491708,-96.9704894,17860,38.9864864,-92.5851888,private,0,0,16,0,0,16,16,0,0,47,0,0,47,47,3.022440711
26420,29.7495926,-95.3536422,26620,34.7832617,-86.7348706,private,0,0,20,0,0,20,20,0,0,47,0,0,47,47,3.022440711
26420,29.7495926,-95.3536422,37100,34.3587415,-119.1331432,private,0,0,25,0,0,25,25,0,0,31,0,0,31,31,3.012467061
38060,33.1857653,-112.0678624,23540,29.4807065,-82.6274667,private,0,0,11,0,0,11,11,16,0,15,0,0,31,31,3.012467061
38060,33.1857653,-112.0678624,39540,42.7541215,-87.4208775,private,0,18,12,0,18,12,30,0,13,18,0,13,18,31,3.012467061
49740,32.7739424,-113.910905,34940,26.118786,-81.4009553,private,0,0,21,0,0,21,21,13,0,18,0,0,31,31,3.012467061
49740,32.7739424,-113.910905,28940,36.0147907,-84.2067014,private,0,0,13,0,0,13,13,12,0,46,0,0,58,58,3.029297594
49740,32.7739424,-113.910905,25060,30.4801526,-88.9992972,private,0,0,15,0,0,15,15,13,0,18,0,0,31,31,3.012467061
49740,32.7739424,-113.910905,31740,39.2684241,-96.5622422,private,12,0,17,0,0,29,29,16,0,15,0,0,31,31,3.012467061
31080,34.1087033,-118.1827533,16860,35.0493612,-85.3611582,private,0,0,0,0,0,0,0,15,0,53,0,0,68,68,3.035531125
41860,37.7737185,-122.2744317,25540,41.7186503,-72.5739191,private,0,0,0,0,0,0,0,0,0,59,0,0,59,59,3.029920947
41860,37.7737185,-122.2744317,15980,26.5590348,-81.8919943,private,0,0,17,0,0,17,17,0,0,54,0,0,54,54,3.026804182
42660,47.4905993,-121.833996,24340,43.0375977,-85.7781669,private,0,0,36,0,0,36,36,0,0,58,0,0,58,58,3.029297594
14460,42.517606,-71.0219925,11700,35.5956693,-82.6816145,private,0,0,49,0,0,49,49,0,0,43,0,0,43,43,3.019947298
14460,42.517606,-71.0219925,14020,39.2417362,-86.6717544,private,0,0,30,0,0,30,30,0,0,17,0,0,17,17,3.003740118
14460,42.517606,-71.0219925,22220,36.1163935,-94.0795449,private,0,0,30,0,0,30,30,0,0,20,0,0,20,20,3.005610178
37980,39.8949576,-75.3119824,31340,37.3649258,-79.2166894,private,0,0,50,0,0,50,50,0,0,25,0,0,25,25,3.008726943
12060,33.693728,-84.3999113,39100,41.5752737,-74.0338729,private,0,0,72,0,0,72,72,0,0,83,0,0,83,83,3.044881421
33100,26.1018281,-80.4787552,14500,40.0949699,-105.3976911,private,0,0,30,0,0,30,30,0,0,39,0,0,39,39,3.017453886
16980,41.8235214,-87.8282967,30780,34.7557726,-92.4005889,private,0,0,82,0,0,82,82,0,0,65,0,0,65,65,3.033661066
26420,29.7495926,-95.3536422,25540,41.7186503,-72.5739191,private,0,0,42,0,0,42,42,0,0,19,0,0,19,19,3.004986825
26420,29.7495926,-95.3536422,35300,41.3497185,-72.9002033,private,0,0,48,0,0,48,48,0,0,42,0,0,42,42,3.019323945
38060,33.1857653,-112.0678624,29460,27.9536488,-81.6935337,private,0,0,48,0,0,48,48,0,0,45,0,0,45,45,3.021194004
49740,32.7739424,-113.910905,12580,39.304361,-76.5495009,private,0,0,54,0,0,54,54,0,0,30,0,0,30,30,3.011843708
31080,34.1087033,-118.1827533,47380,31.4272264,-97.0934727,private,0,0,30,0,0,30,30,0,0,39,0,0,39,39,3.017453886
42660,47.4905993,-121.833996,12540,35.3466288,-118.7295064,private,11,0,68,0,0,79,79,0,0,101,0,0,101,101,3.056101777
34580,48.4932917,-121.8157703,18580,27.8335972,-97.5089575,private,12,0,18,0,0,30,30,0,0,14,0,0,14,14,3.001870059
43220,47.3541257,-123.1738498,15140,35.5866782,-89.2826913,private,17,0,13,0,0,30,30,0,0,14,0,0,14,14,3.001870059
42660,47.4905993,-121.833996,12260,33.4603713,-81.9828327,private,17,0,32,0,0,49,49,28,0,25,0,0,53,53,3.026180829
14460,42.517606,-71.0219925,35100,35.1168292,-77.0813197,private,0,0,21,0,0,21,21,0,0,30,0,0,30,30,3.011843708
35620,40.77493,-73.873758,39060,40.703682,-76.2177878,private,0,0,15,0,0,15,15,11,0,36,0,0,47,47,3.022440711
35620,40.77493,-73.873758,33700,37.5623162,-121.0028311,private,0,0,31,0,0,31,31,0,0,54,0,0,54,54,3.026804182
37980,39.8949576,-75.3119824,35100,35.1168292,-77.0813197,private,0,0,39,0,0,39,39,0,0,45,0,0,45,45,3.021194004
37980,39.8949576,-75.3119824,19430,39.8288538,-84.1418129,private,0,0,20,0,0,20,20,0,0,30,0,0,30,30,3.011843708
47900,38.7982054,-77.4868816,29060,43.5191091,-71.4253661,private,0,0,14,0,0,14,14,0,14,16,0,14,16,30,3.011843708
47900,38.7982054,-77.4868816,24020,43.4404503,-73.6367573,private,0,0,0,0,0,0,0,0,13,17,0,13,17,30,3.011843708
47900,38.7982054,-77.4868816,46380,39.4323876,-123.4428811,private,0,0,22,0,0,22,22,0,0,30,0,0,30,30,3.011843708
47900,38.7982054,-77.4868816,34580,48.4932917,-121.8157703,private,0,0,18,0,0,18,18,0,0,30,0,0,30,30,3.011843708
12060,33.693728,-84.3999113,28020,42.2462657,-85.5328544,private,0,0,94,0,0,94,94,0,0,50,0,0,50,50,3.02431077
12060,33.693728,-84.3999113,14260,43.0066485,-116.1419089,private,0,0,0,0,0,0,0,11,0,35,0,0,46,46,3.021817358
12060,33.693728,-84.3999113,30780,34.7557726,-92.4005889,private,0,0,69,0,0,69,69,0,0,122,0,0,122,122,3.069192191
33100,26.1018281,-80.4787552,15540,44.6891168,-73.0411707,private,0,19,0,0,19,0,19,0,12,37,0,12,37,49,3.023687417
33100,26.1018281,-80.4787552,22220,36.1163935,-94.0795449,private,11,0,0,0,0,11,11,13,0,43,0,0,56,56,3.028050888
33100,26.1018281,-80.4787552,10740,35.1234965,-106.4583918,private,0,0,53,0,0,53,53,0,0,52,0,0,52,52,3.025557476
33100,26.1018281,-80.4787552,28140,38.9318494,-94.4438241,private,0,0,84,0,0,84,84,11,0,90,0,0,101,101,3.056101777
16980,41.8235214,-87.8282967,39100,41.5752737,-74.0338729,private,0,0,46,0,0,46,46,0,0,49,0,0,49,49,3.023687417
19100,32.8491708,-96.9704894,27900,37.0555457,-94.3397364,private,0,0,37,0,0,37,37,0,0,41,0,0,41,41,3.018700592
26420,29.7495926,-95.3536422,30700,40.8174581,-96.8687434,private,0,0,19,0,0,19,19,0,0,30,0,0,30,30,3.011843708
38060,33.1857653,-112.0678624,39820,40.7605142,-122.0435556,private,0,0,58,0,0,58,58,0,0,49,0,0,49,49,3.023687417
38060,33.1857653,-112.0678624,40060,37.4113241,-77.4418164,private,11,0,73,0,0,84,84,12,0,76,0,0,88,88,3.047998187
38060,33.1857653,-112.0678624,35940,41.1450798,-82.594641,private,11,13,28,0,13,39,52,11,11,19,0,11,30,41,3.018700592
38060,33.1857653,-112.0678624,31740,39.2684241,-96.5622422,private,0,0,28,0,0,28,28,11,0,19,0,0,30,30,3.011843708
38060,33.1857653,-112.0678624,10460,32.6155988,-105.7513079,private,0,0,37,0,0,37,37,0,11,56,0,11,56,67,3.034907772
38060,33.1857653,-112.0678624,42200,34.5370572,-120.0399729,private,0,0,35,0,0,35,35,0,0,44,0,0,44,44,3.020570651
31080,34.1087033,-118.1827533,10900,40.7893392,-75.398158,private,0,0,13,0,0,13,13,0,0,30,0,0,30,30,3.011843708
31080,34.1087033,-118.1827533,37860,30.6554013,-87.1618275,private,0,0,54,0,0,54,54,0,0,73,0,0,73,73,3.038647891
31080,34.1087033,-118.1827533,29460,27.9536488,-81.6935337,private,0,0,34,0,0,34,34,0,0,73,0,0,73,73,3.038647891
31080,34.1087033,-118.1827533,16580,40.1029885,-88.3185039,private,0,0,13,0,0,13,13,0,0,30,0,0,30,30,3.011843708
31080,34.1087033,-118.1827533,16180,39.1530598,-119.7473681,private,0,0,47,0,0,47,47,0,0,30,0,0,30,30,3.011843708
41860,37.7737185,-122.2744317,39100,41.5752737,-74.0338729,private,0,0,0,0,0,0,0,0,0,64,0,0,64,64,3.033037713
41860,37.7737185,-122.2744317,15620,44.3287385,-85.3264287,private,0,0,0,0,0,0,0,0,0,30,0,0,30,30,3.011843708
43220,47.3541257,-123.1738498,25980,31.7787881,-81.5764801,private,15,0,0,0,0,15,15,14,0,16,0,0,30,30,3.011843708
14460,42.517606,-71.0219925,12300,44.4170119,-69.7657639,private,0,0,29,0,0,29,29,0,0,22,0,0,22,22,3.006856884
33100,26.1018281,-80.4787552,37100,34.3587415,-119.1331432,private,0,0,46,0,0,46,46,0,0,12,0,0,12,12,3.000623353
16980,41.8235214,-87.8282967,20740,44.9386719,-91.2843222,private,0,0,90,0,0,90,90,0,0,58,0,0,58,58,3.029297594
16980,41.8235214,-87.8282967,45220,30.3864255,-84.2804096,private,0,0,52,0,0,52,52,0,0,45,0,0,45,45,3.021194004
16980,41.8235214,-87.8282967,33540,47.0272632,-113.8926911,private,11,0,31,0,0,42,42,0,0,13,0,0,13,13,3.001246706
19100,32.8491708,-96.9704894,25460,36.0878092,-93.1620533,private,11,0,44,0,0,55,55,11,0,19,0,0,30,30,3.011843708
20900,29.2784805,-96.2296745,35840,27.3642461,-82.3193579,private,0,0,29,0,0,29,29,14,0,14,0,0,28,28,3.010597002
38060,33.1857653,-112.0678624,36300,44.4881125,-75.074311,private,0,16,13,0,16,13,29,0,15,12,0,15,12,27,3.009973649
38060,33.1857653,-112.0678624,16100,32.4578347,-104.3064338,private,0,0,57,0,0,57,57,0,0,42,0,0,42,42,3.019323945
49740,32.7739424,-113.910905,33660,30.9715095,-88.20787,private,13,0,16,0,0,29,29,0,0,13,0,0,13,13,3.001246706
49740,32.7739424,-113.910905,31140,38.3058381,-85.6816455,private,0,0,43,0,0,43,43,0,0,25,0,0,25,25,3.008726943
49740,32.7739424,-113.910905,29200,40.4821533,-87.0171117,private,0,0,29,0,0,29,29,0,0,22,0,0,22,22,3.006856884
49740,32.7739424,-113.910905,44100,39.828565,-89.6962052,private,12,17,0,0,17,12,29,0,15,12,0,15,12,27,3.009973649
14460,42.517606,-71.0219925,44300,40.9091275,-77.8478769,private,0,0,27,0,0,27,27,0,0,29,0,0,29,29,3.011220355
14460,42.517606,-71.0219925,41540,38.3995211,-75.4782615,private,0,0,17,0,0,17,17,0,0,29,0,0,29,29,3.011220355
14460,42.517606,-71.0219925,25940,32.3867916,-80.8308775,private,0,0,28,0,0,28,28,0,18,11,0,18,11,29,3.011220355
14460,42.517606,-71.0219925,37860,30.6554013,-87.1618275,private,0,0,27,0,0,27,27,0,0,29,0,0,29,29,3.011220355
14460,42.517606,-71.0219925,36100,29.2028047,-82.0431004,private,0,0,15,0,0,15,15,0,0,29,0,0,29,29,3.011220355
35620,40.77493,-73.873758,29620,42.7712334,-84.4960294,private,0,0,46,0,0,46,46,0,0,67,0,0,67,67,3.034907772
35620,40.77493,-73.873758,16300,42.0863293,-91.6311439,private,0,0,26,0,0,26,26,0,0,51,0,0,51,51,3.024934123
35620,40.77493,-73.873758,32580,26.3963839,-98.18099,private,0,0,28,0,0,28,28,0,0,43,0,0,43,43,3.019947298
35620,40.77493,-73.873758,33540,47.0272632,-113.8926911,private,0,0,0,0,0,0,0,0,0,45,0,0,45,45,3.021194004
37980,39.8949576,-75.3119824,32820,35.0244194,-89.8719712,private,0,0,16,0,0,16,16,0,0,29,0,0,29,29,3.011220355
47900,38.7982054,-77.4868816,36380,27.3855924,-80.8873884,private,0,0,11,0,0,11,11,0,0,29,0,0,29,29,3.011220355
33100,26.1018281,-80.4787552,31340,37.3649258,-79.2166894,private,0,0,11,0,0,11,11,0,0,29,0,0,29,29,3.011220355
33100,26.1018281,-80.4787552,26620,34.7832617,-86.7348706,private,0,0,41,0,0,41,41,11,0,37,0,0,48,48,3.023064064
33100,26.1018281,-80.4787552,24580,44.4740244,-87.9961303,private,0,15,0,0,15,0,15,0,14,15,0,14,15,29,3.011220355
16980,41.8235214,-87.8282967,43620,43.4954205,-96.9953387,private,0,0,32,0,0,32,32,0,0,54,0,0,54,54,3.026804182
16980,41.8235214,-87.8282967,40700,43.2863277,-123.154476,private,0,0,37,0,0,37,37,0,0,29,0,0,29,29,3.011220355
19100,32.8491708,-96.9704894,15380,43.0443711,-78.7773351,private,0,0,53,0,0,53,53,12,0,33,0,0,45,45,3.021194004
19100,32.8491708,-96.9704894,15620,44.3287385,-85.3264287,private,0,11,0,0,11,0,11,0,16,13,0,16,13,29,3.011220355
20900,29.2784805,-96.2296745,32820,35.0244194,-89.8719712,private,0,0,13,0,0,13,13,0,0,45,0,0,45,45,3.021194004
38060,33.1857653,-112.0678624,35900,36.2088833,-81.1660949,private,0,0,24,0,0,24,24,0,0,29,0,0,29,29,3.011220355
38060,33.1857653,-112.0678624,32580,26.3963839,-98.18099,private,0,0,31,0,0,31,31,0,0,50,0,0,50,50,3.02431077
31080,34.1087033,-118.1827533,12020,33.943984,-83.2138965,private,0,0,17,0,0,17,17,0,0,29,0,0,29,29,3.011220355
31080,34.1087033,-118.1827533,42340,32.1091533,-81.2731066,private,0,0,29,0,0,29,29,0,0,42,0,0,42,42,3.019323945
31080,34.1087033,-118.1827533,23060,41.1131166,-85.2177047,private,0,0,29,0,0,29,29,11,0,18,0,0,29,29,3.011220355
31080,34.1087033,-118.1827533,48580,42.6681095,-88.5417306,private,0,0,30,0,0,30,30,0,0,29,0,0,29,29,3.011220355
41860,37.7737185,-122.2744317,49340,42.2173112,-71.9255354,private,0,0,0,0,0,0,0,0,0,40,0,0,40,40,3.018077239
41860,37.7737185,-122.2744317,31700,42.9115317,-71.7230554,private,0,0,0,0,0,0,0,0,0,44,0,0,44,44,3.020570651
41860,37.7737185,-122.2744317,31140,38.3058381,-85.6816455,private,0,0,13,0,0,13,13,0,0,44,0,0,44,44,3.020570651
42660,47.4905993,-121.833996,48620,37.637896,-97.2462875,private,0,0,36,0,0,36,36,0,0,66,0,0,66,66,3.034284419
42660,47.4905993,-121.833996,32820,35.0244194,-89.8719712,private,0,0,38,0,0,38,38,0,0,46,0,0,46,46,3.021817358
34580,48.4932917,-121.8157703,43900,34.9332708,-81.9910522,private,0,0,0,0,0,0,0,0,0,29,0,0,29,29,3.011220355
34580,48.4932917,-121.8157703,15140,35.5866782,-89.2826913,private,14,0,13,0,0,27,27,11,0,18,0,0,29,29,3.011220355
43220,47.3541257,-123.1738498,37120,31.4306536,-85.609476,private,0,0,12,0,0,12,12,13,0,16,0,0,29,29,3.011220355
43220,47.3541257,-123.1738498,28540,55.4499378,-131.1066847,private,11,0,13,0,0,24,24,0,13,16,0,13,16,29,3.011220355
14460,42.517606,-71.0219925,43220,47.3541257,-123.1738498,private,0,0,28,0,0,28,28,0,0,26,0,0,26,26,3.009350296
35620,40.77493,-73.873758,28660,31.2027301,-97.7896384,private,12,0,68,0,0,80,80,0,0,89,0,0,89,89,3.04862154
47900,38.7982054,-77.4868816,18500,42.2667252,-77.3855253,private,0,0,28,0,0,28,28,0,0,27,0,0,27,27,3.009973649
12060,33.693728,-84.3999113,44140,42.3648332,-72.6194063,private,12,0,42,0,0,54,54,0,0,32,0,0,32,32,3.013090415
33100,26.1018281,-80.4787552,20660,38.7483486,-76.1784757,private,0,28,0,0,28,0,28,0,20,0,0,20,0,20,3.005610178
33460,45.096664,-93.275361,32820,35.0244194,-89.8719712,private,0,0,28,0,0,28,28,0,0,43,0,0,43,43,3.019947298
33460,45.096664,-93.275361,14500,40.0949699,-105.3976911,private,0,0,43,0,0,43,43,0,0,27,0,0,27,27,3.009973649
16980,41.8235214,-87.8282967,21780,38.0200703,-87.5861659,private,0,0,68,0,0,68,68,0,0,58,0,0,58,58,3.029297594
16980,41.8235214,-87.8282967,23420,36.7610058,-119.6550193,private,0,0,28,0,0,28,28,0,0,37,0,0,37,37,3.01620718
19100,32.8491708,-96.9704894,20500,36.0605886,-78.9897875,private,0,0,46,0,0,46,46,0,0,50,0,0,50,50,3.02431077
26420,29.7495926,-95.3536422,24660,36.0252039,-79.7926333,private,0,0,56,0,0,56,56,0,0,57,0,0,57,57,3.028674241
26420,29.7495926,-95.3536422,29200,40.4821533,-87.0171117,private,0,0,28,0,0,28,28,0,0,16,0,0,16,16,3.003116765
26420,29.7495926,-95.3536422,30020,34.5291104,-98.4309172,private,11,0,17,0,0,28,28,0,0,44,0,0,44,44,3.020570651
20900,29.2784805,-96.2296745,16700,33.0180695,-80.0075006,private,12,0,16,0,0,28,28,14,0,0,0,0,14,14,3.001870059
20900,29.2784805,-96.2296745,33460,45.096664,-93.275361,private,16,0,42,0,0,58,58,0,0,25,0,0,25,25,3.008726943
49740,32.7739424,-113.910905,30620,40.7716274,-84.1061032,private,12,0,16,0,0,28,28,0,0,17,0,0,17,17,3.003740118
42660,47.4905993,-121.833996,34740,43.2892579,-86.751892,private,11,0,38,0,0,49,49,0,0,35,0,0,35,35,3.014960474
34580,48.4932917,-121.8157703,41180,38.7402108,-90.3458253,private,11,0,52,0,0,63,63,15,0,19,0,0,34,34,3.014337121
43220,47.3541257,-123.1738498,39300,41.7068313,-71.2866369,private,14,0,14,0,0,28,28,0,0,32,0,0,32,32,3.013090415
43220,47.3541257,-123.1738498,17980,32.4193768,-84.8437095,private,13,0,15,0,0,28,28,0,0,21,0,0,21,21,3.006233531
43220,47.3541257,-123.1738498,41940,36.9084718,-121.3713721,private,0,0,43,0,0,43,43,0,0,32,0,0,32,32,3.013090415
14460,42.517606,-71.0219925,42340,32.1091533,-81.2731066,private,0,0,11,0,0,11,11,0,0,28,0,0,28,28,3.010597002
35620,40.77493,-73.873758,49660,41.23646,-80.5617836,private,0,0,21,0,0,21,21,0,12,27,0,12,27,39,3.017453886
35620,40.77493,-73.873758,10140,47.1137324,-123.8267349,private,0,0,45,0,0,45,45,0,0,52,0,0,52,52,3.025557476
37980,39.8949576,-75.3119824,38860,43.6514172,-70.4183755,private,0,0,40,0,0,40,40,0,17,42,0,17,42,59,3.029920947
47900,38.7982054,-77.4868816,16540,39.9267722,-77.7245208,private,0,0,0,0,0,0,0,0,12,16,0,12,16,28,3.010597002
47900,38.7982054,-77.4868816,25720,40.6913977,-111.0527658,private,0,0,24,0,0,24,24,0,0,28,0,0,28,28,3.010597002
33100,26.1018281,-80.4787552,18260,36.2772512,-85.4685013,private,0,0,0,0,0,0,0,11,0,17,0,0,28,28,3.010597002
33100,26.1018281,-80.4787552,37940,40.7728833,-86.0442575,private,0,0,29,0,0,29,29,0,0,41,0,0,41,41,3.018700592
16980,41.8235214,-87.8282967,18500,42.2667252,-77.3855253,private,0,0,27,0,0,27,27,0,0,28,0,0,28,28,3.010597002
16980,41.8235214,-87.8282967,49180,36.0788515,-80.3450642,private,0,0,20,0,0,20,20,0,0,28,0,0,28,28,3.010597002
16980,41.8235214,-87.8282967,24660,36.0252039,-79.7926333,private,0,0,109,0,0,109,109,0,0,113,0,0,113,113,3.063582013
16980,41.8235214,-87.8282967,12020,33.943984,-83.2138965,private,0,0,25,0,0,25,25,0,0,46,0,0,46,46,3.021817358
16980,41.8235214,-87.8282967,35940,41.1450798,-82.594641,private,0,0,11,0,0,11,11,0,0,28,0,0,28,28,3.010597002
16980,41.8235214,-87.8282967,39900,40.5007953,-119.7311608,private,0,0,34,0,0,34,34,0,0,45,0,0,45,45,3.021194004
19100,32.8491708,-96.9704894,25940,32.3867916,-80.8308775,private,0,0,24,0,0,24,24,11,0,17,0,0,28,28,3.010597002
26420,29.7495926,-95.3536422,36100,29.2028047,-82.0431004,private,0,0,40,0,0,40,40,0,0,44,0,0,44,44,3.020570651
26420,29.7495926,-95.3536422,33700,37.5623162,-121.0028311,private,0,0,18,0,0,18,18,0,0,28,0,0,28,28,3.010597002
38060,33.1857653,-112.0678624,12620,45.4092843,-68.666616,private,0,0,0,0,0,0,0,15,0,25,0,0,40,40,3.018077239
49740,32.7739424,-113.910905,36460,42.2390986,-78.662332,private,0,12,0,0,12,0,12,0,14,14,0,14,14,28,3.010597002
49740,32.7739424,-113.910905,18580,27.8335972,-97.5089575,private,0,0,0,0,0,0,0,14,0,14,0,0,28,28,3.010597002
31080,34.1087033,-118.1827533,28940,36.0147907,-84.2067014,private,0,0,66,0,0,66,66,0,0,93,0,0,93,93,3.051114952
31080,34.1087033,-118.1827533,14020,39.2417362,-86.6717544,private,0,0,18,0,0,18,18,0,0,28,0,0,28,28,3.010597002
31080,34.1087033,-118.1827533,43340,32.4376822,-93.7448836,private,0,0,13,0,0,13,13,0,0,28,0,0,28,28,3.010597002
42660,47.4905993,-121.833996,45940,40.2825026,-74.703724,private,12,0,35,0,0,47,47,0,0,28,0,0,28,28,3.010597002
34580,48.4932917,-121.8157703,29460,27.9536488,-81.6935337,private,0,0,14,0,0,14,14,13,0,15,0,0,28,28,3.010597002
43220,47.3541257,-123.1738498,23620,33.6391964,-97.2103433,private,0,0,13,0,0,13,13,13,0,15,0,0,28,28,3.010597002
43220,47.3541257,-123.1738498,39900,40.5007953,-119.7311608,private,0,0,14,0,0,14,14,15,0,13,0,0,28,28,3.010597002
14460,42.517606,-71.0219925,30460,38.1028763,-84.4385451,private,11,0,16,0,0,27,27,0,0,23,0,0,23,23,3.007480237
47900,38.7982054,-77.4868816,30100,43.7857256,-72.1591415,private,0,0,27,0,0,27,27,0,0,38,0,0,38,38,3.016830533
12060,33.693728,-84.3999113,45780,41.5553128,-83.5170883,private,0,0,54,0,0,54,54,0,0,64,0,0,64,64,3.033037713
12060,33.693728,-84.3999113,29940,38.8964168,-95.2909475,private,13,0,14,0,0,27,27,0,0,45,0,0,45,45,3.021194004
16980,41.8235214,-87.8282967,10540,44.4888982,-122.5372084,private,0,0,41,0,0,41,41,0,0,40,0,0,40,40,3.018077239
16980,41.8235214,-87.8282967,10140,47.1137324,-123.8267349,private,0,0,66,0,0,66,66,0,0,32,0,0,32,32,3.013090415
26420,29.7495926,-95.3536422,10140,47.1137324,-123.8267349,private,0,0,40,0,0,40,40,0,0,43,0,0,43,43,3.019947298
20900,29.2784805,-96.2296745,40900,38.7896779,-121.0057504,private,14,0,13,0,0,27,27,0,0,35,0,0,35,35,3.014960474
26420,29.7495926,-95.3536422,41660,31.4798393,-100.7745902,private,11,0,38,0,0,49,49,0,0,32,0,0,32,32,3.013090415
38060,33.1857653,-112.0678624,27220,44.048662,-110.426087,private,0,27,0,0,27,0,27,0,22,0,0,22,0,22,3.006856884
49740,32.7739424,-113.910905,38300,40.4395249,-79.8360972,private,0,26,52,0,26,52,78,0,0,56,0,0,56,56,3.028050888
49740,32.7739424,-113.910905,32820,35.0244194,-89.8719712,private,16,0,23,0,0,39,39,0,0,29,0,0,29,29,3.011220355
49740,32.7739424,-113.910905,15940,40.7110505,-81.261468,private,13,14,0,0,14,13,27,0,15,0,0,15,0,15,3.002493412
31080,34.1087033,-118.1827533,19430,39.8288538,-84.1418129,private,0,0,51,0,0,51,51,0,0,34,0,0,34,34,3.014337121
42660,47.4905993,-121.833996,48580,42.6681095,-88.5417306,private,13,0,36,0,0,49,49,0,0,42,0,0,42,42,3.019323945
42660,47.4905993,-121.833996,21700,40.7066554,-123.9261757,private,0,0,44,0,0,44,44,0,0,12,0,0,12,12,3.000623353
34580,48.4932917,-121.8157703,28140,38.9318494,-94.4438241,private,0,0,38,0,0,38,38,0,0,24,0,0,24,24,3.00810359
34580,48.4932917,-121.8157703,46140,36.2544287,-96.1773294,private,13,0,14,0,0,27,27,0,0,17,0,0,17,17,3.003740118
43220,47.3541257,-123.1738498,25060,30.4801526,-88.9992972,private,12,0,15,0,0,27,27,0,0,13,0,0,13,13,3.001246706
43220,47.3541257,-123.1738498,22220,36.1163935,-94.0795449,private,13,0,14,0,0,27,27,0,0,14,0,0,14,14,3.001870059
14460,42.517606,-71.0219925,28940,36.0147907,-84.2067014,private,0,0,17,0,0,17,17,0,0,27,0,0,27,27,3.009973649
14460,42.517606,-71.0219925,37100,34.3587415,-119.1331432,private,0,0,17,0,0,17,17,0,0,27,0,0,27,27,3.009973649
35620,40.77493,-73.873758,12940,30.5187808,-91.1255901,private,0,0,16,0,0,16,16,0,0,40,0,0,40,40,3.018077239
35620,40.77493,-73.873758,45000,40.7210862,-120.6299518,private,0,0,12,0,0,12,12,0,0,46,0,0,46,46,3.021817358
37980,39.8949576,-75.3119824,11700,35.5956693,-82.6816145,private,0,0,60,0,0,60,60,0,0,64,0,0,64,64,3.033037713
37980,39.8949576,-75.3119824,42340,32.1091533,-81.2731066,private,0,0,36,0,0,36,36,0,0,41,0,0,41,41,3.018700592
37980,39.8949576,-75.3119824,28140,38.9318494,-94.4438241,private,0,0,41,0,0,41,41,0,0,27,0,0,27,27,3.009973649
37980,39.8949576,-75.3119824,46060,32.1280427,-111.7836574,private,0,0,46,0,0,46,46,0,0,47,0,0,47,47,3.022440711
47900,38.7982054,-77.4868816,49180,36.0788515,-80.3450642,private,0,0,24,0,0,24,24,0,0,27,0,0,27,27,3.009973649
47900,38.7982054,-77.4868816,45220,30.3864255,-84.2804096,private,0,0,18,0,0,18,18,0,0,27,0,0,27,27,3.009973649
47900,38.7982054,-77.4868816,21340,31.527394,-105.5213326,private,0,0,18,0,0,18,18,0,0,27,0,0,27,27,3.009973649
47900,38.7982054,-77.4868816,14260,43.0066485,-116.1419089,private,0,0,13,0,0,13,13,0,0,40,0,0,40,40,3.018077239
12060,33.693728,-84.3999113,42820,32.3335397,-87.1143556,private,0,0,56,0,0,56,56,0,0,52,0,0,52,52,3.025557476
12060,33.693728,-84.3999113,16580,40.1029885,-88.3185039,private,0,0,40,0,0,40,40,0,0,45,0,0,45,45,3.021194004
33460,45.096664,-93.275361,14260,43.0066485,-116.1419089,private,0,0,76,0,0,76,76,0,0,55,0,0,55,55,3.027427535
16980,41.8235214,-87.8282967,44180,37.3608699,-93.1802617,private,22,0,98,0,0,120,120,15,0,114,0,0,129,129,3.073555663
16980,41.8235214,-87.8282967,44140,42.3648332,-72.6194063,private,0,0,25,0,0,25,25,0,0,27,0,0,27,27,3.009973649
16980,41.8235214,-87.8282967,40220,37.2862262,-79.9469346,private,0,0,20,0,0,20,20,0,0,27,0,0,27,27,3.009973649
19100,32.8491708,-96.9704894,44260,33.5146172,-89.0775079,private,0,0,30,0,0,30,30,0,0,40,0,0,40,40,3.018077239
19100,32.8491708,-96.9704894,23060,41.1131166,-85.2177047,private,0,0,19,0,0,19,19,0,0,44,0,0,44,44,3.020570651
19100,32.8491708,-96.9704894,16100,32.4578347,-104.3064338,private,0,0,37,0,0,37,37,0,0,53,0,0,53,53,3.026180829
19100,32.8491708,-96.9704894,19780,41.5770501,-93.7597124,private,12,0,51,0,0,63,63,0,0,81,0,0,81,81,3.043634715
26420,29.7495926,-95.3536422,40380,43.148038,-77.5232575,private,0,0,12,0,0,12,12,0,0,38,0,0,38,38,3.016830533
26420,29.7495926,-95.3536422,25940,32.3867916,-80.8308775,private,0,0,0,0,0,0,0,11,0,16,0,0,27,27,3.009973649
26420,29.7495926,-95.3536422,36380,27.3855924,-80.8873884,private,0,0,20,0,0,20,20,0,0,38,0,0,38,38,3.016830533
20900,29.2784805,-96.2296745,33740,32.734255,-92.0995498,private,0,0,26,0,0,26,26,11,0,16,0,0,27,27,3.009973649
49740,32.7739424,-113.910905,39300,41.7068313,-71.2866369,private,0,14,40,0,14,40,54,12,0,15,0,0,27,27,3.009973649
49740,32.7739424,-113.910905,27620,38.6368854,-92.088876,private,0,19,0,0,19,0,19,0,14,13,0,14,13,27,3.009973649
31080,34.1087033,-118.1827533,38340,42.371493,-73.2179276,private,0,0,0,0,0,0,0,0,0,27,0,0,27,27,3.009973649
31080,34.1087033,-118.1827533,31700,42.9115317,-71.7230554,private,0,0,16,0,0,16,16,0,0,53,0,0,53,53,3.026180829
31080,34.1087033,-118.1827533,49180,36.0788515,-80.3450642,private,0,0,12,0,0,12,12,0,0,38,0,0,38,38,3.016830533
41860,37.7737185,-122.2744317,39340,39.872067,-112.3590592,private,0,0,0,0,0,0,0,15,0,12,0,0,27,27,3.009973649
42660,47.4905993,-121.833996,34940,26.118786,-81.4009553,private,0,0,28,0,0,28,28,11,0,34,0,0,45,45,3.021194004
34580,48.4932917,-121.8157703,39300,41.7068313,-71.2866369,private,11,0,0,0,0,11,11,11,0,16,0,0,27,27,3.009973649
34580,48.4932917,-121.8157703,25060,30.4801526,-88.9992972,private,0,0,15,0,0,15,15,16,0,11,0,0,27,27,3.009973649
42660,47.4905993,-121.833996,40620,37.8663263,-91.7903492,private,0,0,0,0,0,0,0,11,0,16,0,0,27,27,3.009973649
47900,38.7982054,-77.4868816,37100,34.3587415,-119.1331432,private,0,0,26,0,0,26,26,0,0,25,0,0,25,25,3.008726943
12060,33.693728,-84.3999113,41980,18.2944526,-66.0368437,private,0,0,61,0,0,61,61,0,0,57,0,0,57,57,3.028674241
12060,33.693728,-84.3999113,14540,37.0468241,-86.3970408,private,0,0,26,0,0,26,26,0,0,29,0,0,29,29,3.011220355
12060,33.693728,-84.3999113,37100,34.3587415,-119.1331432,private,13,0,41,0,0,54,54,0,0,31,0,0,31,31,3.012467061
33100,26.1018281,-80.4787552,46140,36.2544287,-96.1773294,private,0,0,68,0,0,68,68,11,0,70,0,0,81,81,3.043634715
33100,26.1018281,-80.4787552,17980,32.4193768,-84.8437095,private,0,0,39,0,0,39,39,0,0,38,0,0,38,38,3.016830533
33460,45.096664,-93.275361,35900,36.2088833,-81.1660949,private,0,0,26,0,0,26,26,0,0,12,0,0,12,12,3.000623353
19100,32.8491708,-96.9704894,27740,36.2658223,-82.3326926,private,13,0,24,0,0,37,37,0,0,20,0,0,20,20,3.005610178
19100,32.8491708,-96.9704894,30460,38.1028763,-84.4385451,private,15,0,32,0,0,47,47,11,0,50,0,0,61,61,3.031167654
19100,32.8491708,-96.9704894,15780,33.5675198,-92.7082209,private,0,0,61,0,0,61,61,0,0,47,0,0,47,47,3.022440711
26420,29.7495926,-95.3536422,45940,40.2825026,-74.703724,private,0,0,26,0,0,26,26,0,0,14,0,0,14,14,3.001870059
26420,29.7495926,-95.3536422,14260,43.0066485,-116.1419089,private,11,0,43,0,0,54,54,0,0,46,0,0,46,46,3.021817358
20900,29.2784805,-96.2296745,12580,39.304361,-76.5495009,private,12,0,29,0,0,41,41,0,0,27,0,0,27,27,3.009973649
38060,33.1857653,-112.0678624,36380,27.3855924,-80.8873884,private,11,0,15,0,0,26,26,0,0,39,0,0,39,39,3.017453886
38060,33.1857653,-112.0678624,35660,41.7913818,-86.7425435,private,0,14,12,0,14,12,26,0,0,12,0,0,12,12,3.000623353
41860,37.7737185,-122.2744317,39150,34.631071,-112.5772247,private,0,0,44,0,0,44,44,0,0,31,0,0,31,31,3.012467061
42660,47.4905993,-121.833996,15380,43.0443711,-78.7773351,private,0,0,39,0,0,39,39,0,0,42,0,0,42,42,3.019323945
14460,42.517606,-71.0219925,16300,42.0863293,-91.6311439,private,0,0,17,0,0,17,17,0,0,26,0,0,26,26,3.009350296
14460,42.517606,-71.0219925,16580,40.1029885,-88.3185039,private,0,0,25,0,0,25,25,0,0,26,0,0,26,26,3.009350296
37980,39.8949576,-75.3119824,22660,40.6580933,-105.4867638,private,0,0,45,0,0,45,45,0,0,50,0,0,50,50,3.02431077
47900,38.7982054,-77.4868816,42200,34.5370572,-120.0399729,private,0,0,22,0,0,22,22,0,0,26,0,0,26,26,3.009350296
33100,26.1018281,-80.4787552,48140,45.0539796,-89.7579047,private,0,0,0,0,0,0,0,0,11,27,0,11,27,38,3.016830533
33100,26.1018281,-80.4787552,40220,37.2862262,-79.9469346,private,0,0,35,0,0,35,35,0,0,43,0,0,43,43,3.019947298
33100,26.1018281,-80.4787552,40900,38.7896779,-121.0057504,private,0,0,86,0,0,86,86,0,0,94,0,0,94,94,3.051738305
33460,45.096664,-93.275361,47940,42.5367962,-92.471608,private,0,0,46,0,0,46,46,0,0,85,0,0,85,85,3.046128127
26420,29.7495926,-95.3536422,41980,18.2944526,-66.0368437,private,0,0,49,0,0,49,49,0,0,52,0,0,52,52,3.025557476
26420,29.7495926,-95.3536422,49660,41.23646,-80.5617836,private,0,0,12,0,0,12,12,0,0,26,0,0,26,26,3.009350296
38060,33.1857653,-112.0678624,45780,41.5553128,-83.5170883,private,0,0,40,0,0,40,40,11,0,41,0,0,52,52,3.025557476
38060,33.1857653,-112.0678624,17900,34.0775845,-81.0378453,private,0,0,34,0,0,34,34,0,0,67,0,0,67,67,3.034907772
49740,32.7739424,-113.910905,14460,42.517606,-71.0219925,private,0,26,18,0,26,18,44,0,11,56,0,11,56,67,3.034907772
31080,34.1087033,-118.1827533,41980,18.2944526,-66.0368437,private,0,0,20,0,0,20,20,0,0,26,0,0,26,26,3.009350296
31080,34.1087033,-118.1827533,45860,41.7918833,-73.2354042,private,0,0,19,0,0,19,19,0,0,26,0,0,26,26,3.009350296
31080,34.1087033,-118.1827533,24660,36.0252039,-79.7926333,private,0,0,100,0,0,100,100,0,0,78,0,0,78,78,3.041764656
31080,34.1087033,-118.1827533,38500,41.3250032,-86.2690363,private,0,0,18,0,0,18,18,0,0,26,0,0,26,26,3.009350296
31080,34.1087033,-118.1827533,30780,34.7557726,-92.4005889,private,0,0,45,0,0,45,45,12,0,83,0,0,95,95,3.052361658
42660,47.4905993,-121.833996,42460,34.764114,-85.9800556,private,0,0,11,0,0,11,11,11,0,27,0,0,38,38,3.016830533
42660,47.4905993,-121.833996,48900,34.4260331,-77.889634,private,0,0,16,0,0,16,16,0,0,39,0,0,39,39,3.017453886
43220,47.3541257,-123.1738498,28140,38.9318494,-94.4438241,private,0,0,12,0,0,12,12,13,0,28,0,0,41,41,3.018700592
14460,42.517606,-71.0219925,24340,43.0375977,-85.7781669,private,0,0,25,0,0,25,25,0,0,24,0,0,24,24,3.00810359
37980,39.8949576,-75.3119824,11020,40.4986536,-78.3095974,private,0,0,49,0,0,49,49,0,0,48,0,0,48,48,3.023064064
37980,39.8949576,-75.3119824,25980,31.7787881,-81.5764801,private,0,0,25,0,0,25,25,0,0,18,0,0,18,18,3.004363472
47900,38.7982054,-77.4868816,35980,41.4726517,-72.1086339,private,0,0,25,0,0,25,25,0,0,24,0,0,24,24,3.00810359
12060,33.693728,-84.3999113,22420,43.0210768,-83.7063718,private,0,0,38,0,0,38,38,0,0,16,0,0,16,16,3.003116765
12060,33.693728,-84.3999113,43340,32.4376822,-93.7448836,private,0,0,25,0,0,25,25,0,0,29,0,0,29,29,3.011220355
12060,33.693728,-84.3999113,46140,36.2544287,-96.1773294,private,0,0,96,0,0,96,96,0,0,50,0,0,50,50,3.02431077
33100,26.1018281,-80.4787552,29540,40.0419921,-76.250198,private,0,0,36,0,0,36,36,0,0,53,0,0,53,53,3.026180829
33460,45.096664,-93.275361,23420,36.7610058,-119.6550193,private,0,0,44,0,0,44,44,0,0,38,0,0,38,38,3.016830533
33460,45.096664,-93.275361,29940,38.8964168,-95.2909475,private,12,0,40,0,0,52,52,11,0,33,0,0,44,44,3.020570651
33460,45.096664,-93.275361,45940,40.2825026,-74.703724,private,0,0,25,0,0,25,25,0,0,17,0,0,17,17,3.003740118
33460,45.096664,-93.275361,36420,35.4309676,-97.5069659,private,0,0,71,0,0,71,71,0,0,50,0,0,50,50,3.02431077
19100,32.8491708,-96.9704894,31420,32.8562163,-83.714305,private,13,0,12,0,0,25,25,0,0,27,0,0,27,27,3.009973649
19100,32.8491708,-96.9704894,19700,32.1845231,-107.7471911,private,0,0,37,0,0,37,37,0,0,41,0,0,41,41,3.018700592
26420,29.7495926,-95.3536422,23540,29.4807065,-82.6274667,private,0,0,25,0,0,25,25,0,0,24,0,0,24,24,3.00810359
20900,29.2784805,-96.2296745,28940,36.0147907,-84.2067014,private,12,0,31,0,0,43,43,11,0,19,0,0,30,30,3.011843708
49740,32.7739424,-113.910905,10900,40.7893392,-75.398158,private,0,14,11,0,14,11,25,0,12,11,0,12,11,23,3.007480237
49740,32.7739424,-113.910905,46340,32.3770156,-95.2700409,private,0,0,25,0,0,25,25,0,0,20,0,0,20,20,3.005610178
42660,47.4905993,-121.833996,31460,37.2098213,-119.7498023,private,0,0,50,0,0,50,50,0,0,38,0,0,38,38,3.016830533
43220,47.3541257,-123.1738498,41180,38.7402108,-90.3458253,private,13,0,34,0,0,47,47,11,0,0,0,0,11,11,3
42660,47.4905993,-121.833996,31740,39.2684241,-96.5622422,private,13,0,12,0,0,25,25,13,0,11,0,0,24,24,3.00810359
14460,42.517606,-71.0219925,13540,43.0353254,-73.1114603,private,0,0,13,0,0,13,13,0,0,25,0,0,25,25,3.008726943
14460,42.517606,-71.0219925,24660,36.0252039,-79.7926333,private,0,0,52,0,0,52,52,0,0,54,0,0,54,54,3.026804182
14460,42.517606,-71.0219925,21340,31.527394,-105.5213326,private,0,0,18,0,0,18,18,0,0,25,0,0,25,25,3.008726943
35620,40.77493,-73.873758,14020,39.2417362,-86.6717544,private,0,0,20,0,0,20,20,0,0,25,0,0,25,25,3.008726943
35620,40.77493,-73.873758,40340,43.9496362,-92.3360701,private,0,0,19,0,0,19,19,0,0,38,0,0,38,38,3.016830533
35620,40.77493,-73.873758,10540,44.4888982,-122.5372084,private,0,0,0,0,0,0,0,0,0,46,0,0,46,46,3.021817358
47900,38.7982054,-77.4868816,29540,40.0419921,-76.250198,private,0,0,0,0,0,0,0,0,0,50,0,0,50,50,3.02431077
47900,38.7982054,-77.4868816,10420,41.1466395,-81.3501104,private,0,0,19,0,0,19,19,0,0,25,0,0,25,25,3.008726943
47900,38.7982054,-77.4868816,28020,42.2462657,-85.5328544,private,0,0,15,0,0,15,15,0,0,25,0,0,25,25,3.008726943
12060,33.693728,-84.3999113,46520,21.5800225,-158.1234063,private,0,0,33,0,0,33,33,0,0,45,0,0,45,45,3.021194004
12060,33.693728,-84.3999113,10140,47.1137324,-123.8267349,private,0,0,34,0,0,34,34,0,0,25,0,0,25,25,3.008726943
33460,45.096664,-93.275361,26340,47.6819737,-88.1487965,private,0,0,34,0,0,34,34,11,0,50,0,0,61,61,3.031167654
16980,41.8235214,-87.8282967,19700,32.1845231,-107.7471911,private,0,0,26,0,0,26,26,25,0,37,0,0,62,62,3.031791007
16980,41.8235214,-87.8282967,25460,36.0878092,-93.1620533,private,0,0,42,0,0,42,42,12,0,29,0,0,41,41,3.018700592
16980,41.8235214,-87.8282967,10900,40.7893392,-75.398158,private,0,0,21,0,0,21,21,0,0,25,0,0,25,25,3.008726943
16980,41.8235214,-87.8282967,15940,40.7110505,-81.261468,private,0,0,19,0,0,19,19,0,0,44,0,0,44,44,3.020570651
16980,41.8235214,-87.8282967,22020,46.9148591,-96.9601826,private,0,0,16,0,0,16,16,0,0,25,0,0,25,25,3.008726943
19100,32.8491708,-96.9704894,40700,43.2863277,-123.154476,private,0,0,46,0,0,46,46,0,0,41,0,0,41,41,3.018700592
26420,29.7495926,-95.3536422,19780,41.5770501,-93.7597124,private,0,0,28,0,0,28,28,0,0,51,0,0,51,51,3.024934123
26420,29.7495926,-95.3536422,19700,32.1845231,-107.7471911,private,0,0,20,0,0,20,20,0,0,25,0,0,25,25,3.008726943
38060,33.1857653,-112.0678624,43260,44.7813692,-106.8812114,private,0,26,0,0,26,0,26,0,25,12,0,25,12,37,3.01620718
49740,32.7739424,-113.910905,37980,39.8949576,-75.3119824,private,12,11,68,0,11,80,91,0,0,89,0,0,89,89,3.04862154
49740,32.7739424,-113.910905,45780,41.5553128,-83.5170883,private,0,0,15,0,0,15,15,0,0,25,0,0,25,25,3.008726943
31080,34.1087033,-118.1827533,48620,37.637896,-97.2462875,private,0,0,31,0,0,31,31,0,0,50,0,0,50,50,3.02431077
41860,37.7737185,-122.2744317,28060,48.3146779,-114.0542951,private,0,0,14,0,0,14,14,0,0,25,0,0,25,25,3.008726943
43220,47.3541257,-123.1738498,30780,34.7557726,-92.4005889,private,0,0,0,0,0,0,0,13,0,12,0,0,25,25,3.008726943
43220,47.3541257,-123.1738498,22380,35.8296919,-111.7737277,private,0,0,0,0,0,0,0,0,0,25,0,0,25,25,3.008726943
12060,33.693728,-84.3999113,10900,40.7893392,-75.398158,private,0,0,49,0,0,49,49,0,0,45,0,0,45,45,3.021194004
12060,33.693728,-84.3999113,34740,43.2892579,-86.751892,private,0,0,24,0,0,24,24,0,0,47,0,0,47,47,3.022440711
12060,33.693728,-84.3999113,10540,44.4888982,-122.5372084,private,0,0,42,0,0,42,42,0,0,41,0,0,41,41,3.018700592
33100,26.1018281,-80.4787552,21580,36.5096687,-106.6939829,private,0,11,13,0,11,13,24,0,0,18,0,0,18,18,3.004363472
33100,26.1018281,-80.4787552,46520,21.5800225,-158.1234063,private,0,0,45,0,0,45,45,0,0,41,0,0,41,41,3.018700592
33460,45.096664,-93.275361,40060,37.4113241,-77.4418164,private,0,0,24,0,0,24,24,0,0,24,0,0,24,24,3.00810359
33460,45.096664,-93.275361,28020,42.2462657,-85.5328544,private,0,0,39,0,0,39,39,0,0,11,0,0,11,11,3
33460,45.096664,-93.275361,48620,37.637896,-97.2462875,private,0,0,38,0,0,38,38,0,0,17,0,0,17,17,3.003740118
16980,41.8235214,-87.8282967,17900,34.0775845,-81.0378453,private,11,0,95,0,0,106,106,14,0,52,0,0,66,66,3.034284419
19100,32.8491708,-96.9704894,38860,43.6514172,-70.4183755,private,0,13,22,0,13,22,35,0,0,11,0,0,11,11,3
19100,32.8491708,-96.9704894,40220,37.2862262,-79.9469346,private,0,0,39,0,0,39,39,11,0,13,0,0,24,24,3.00810359
19100,32.8491708,-96.9704894,45220,30.3864255,-84.2804096,private,0,0,35,0,0,35,35,0,0,53,0,0,53,53,3.026180829
19100,32.8491708,-96.9704894,29620,42.7712334,-84.4960294,private,0,0,37,0,0,37,37,0,0,42,0,0,42,42,3.019323945
26420,29.7495926,-95.3536422,38860,43.6514172,-70.4183755,private,0,0,24,0,0,24,24,0,0,29,0,0,29,29,3.011220355
38060,33.1857653,-112.0678624,35380,29.805532,-89.7013821,private,0,0,57,0,0,57,57,0,0,37,0,0,37,37,3.01620718
38060,33.1857653,-112.0678624,25940,32.3867916,-80.8308775,private,0,0,24,0,0,24,24,0,0,15,0,0,15,15,3.002493412
38060,33.1857653,-112.0678624,29200,40.4821533,-87.0171117,private,0,0,24,0,0,24,24,0,0,30,0,0,30,30,3.011843708
49740,32.7739424,-113.910905,19860,46.9125835,-102.9884867,private,0,24,0,0,24,0,24,0,22,0,0,22,0,22,3.006856884
49740,32.7739424,-113.910905,11100,35.2478969,-101.9086384,private,12,0,25,0,0,37,37,0,0,22,0,0,22,22,3.006856884
49740,32.7739424,-113.910905,23420,36.7610058,-119.6550193,private,0,0,24,0,0,24,24,0,0,24,0,0,24,24,3.00810359
42660,47.4905993,-121.833996,23060,41.1131166,-85.2177047,private,0,0,40,0,0,40,40,0,0,26,0,0,26,26,3.009350296
42660,47.4905993,-121.833996,11700,35.5956693,-82.6816145,private,0,0,63,0,0,63,63,0,0,55,0,0,55,55,3.027427535
43220,47.3541257,-123.1738498,12580,39.304361,-76.5495009,private,11,0,13,0,0,24,24,0,0,30,0,0,30,30,3.011843708
43220,47.3541257,-123.1738498,46380,39.4323876,-123.4428811,private,0,0,24,0,0,24,24,0,0,23,0,0,23,23,3.007480237
14460,42.517606,-71.0219925,36540,41.2904587,-95.9999701,private,0,0,23,0,0,23,23,0,0,24,0,0,24,24,3.00810359
14460,42.517606,-71.0219925,23620,33.6391964,-97.2103433,private,0,0,21,0,0,21,21,11,0,13,0,0,24,24,3.00810359
14460,42.517606,-71.0219925,10540,44.4888982,-122.5372084,private,0,0,12,0,0,12,12,0,0,24,0,0,24,24,3.00810359
35620,40.77493,-73.873758,49020,39.2729744,-78.4718276,private,0,0,0,0,0,0,0,0,0,38,0,0,38,38,3.016830533
37980,39.8949576,-75.3119824,12740,44.2749884,-72.6095138,private,0,0,0,0,0,0,0,0,0,24,0,0,24,24,3.00810359
37980,39.8949576,-75.3119824,45860,41.7918833,-73.2354042,private,0,0,16,0,0,16,16,0,0,35,0,0,35,35,3.014960474
37980,39.8949576,-75.3119824,11220,42.9008912,-74.4353575,private,0,0,12,0,0,12,12,0,0,24,0,0,24,24,3.00810359
37980,39.8949576,-75.3119824,10580,42.7879202,-73.9423479,private,0,0,32,0,0,32,32,0,0,45,0,0,45,45,3.021194004
37980,39.8949576,-75.3119824,28940,36.0147907,-84.2067014,private,0,0,13,0,0,13,13,0,0,24,0,0,24,24,3.00810359
12060,33.693728,-84.3999113,10380,18.3569648,-67.0078951,private,0,0,15,0,0,15,15,0,0,37,0,0,37,37,3.01620718
33460,45.096664,-93.275361,35300,41.3497185,-72.9002033,private,0,0,22,0,0,22,22,0,0,37,0,0,37,37,3.01620718
33460,45.096664,-93.275361,24860,34.6837085,-82.4134227,private,0,0,33,0,0,33,33,0,0,62,0,0,62,62,3.031791007
33460,45.096664,-93.275361,24340,43.0375977,-85.7781669,private,0,0,45,0,0,45,45,0,0,24,0,0,24,24,3.00810359
19100,32.8491708,-96.9704894,35900,36.2088833,-81.1660949,private,0,0,32,0,0,32,32,11,12,13,0,12,24,36,3.015583827
26420,29.7495926,-95.3536422,39300,41.7068313,-71.2866369,private,0,0,48,0,0,48,48,0,0,61,0,0,61,61,3.031167654
26420,29.7495926,-95.3536422,45220,30.3864255,-84.2804096,private,0,0,20,0,0,20,20,0,0,24,0,0,24,24,3.00810359
26420,29.7495926,-95.3536422,30460,38.1028763,-84.4385451,private,0,0,34,0,0,34,34,11,0,13,0,0,24,24,3.00810359
26420,29.7495926,-95.3536422,48580,42.6681095,-88.5417306,private,0,0,19,0,0,19,19,0,0,24,0,0,24,24,3.00810359
26420,29.7495926,-95.3536422,16580,40.1029885,-88.3185039,private,0,0,14,0,0,14,14,0,0,35,0,0,35,35,3.014960474
26420,29.7495926,-95.3536422,37500,36.1206072,-90.5663459,private,0,0,14,0,0,14,14,0,0,36,0,0,36,36,3.015583827
20900,29.2784805,-96.2296745,13820,33.4025986,-86.7295151,private,0,0,12,0,0,12,12,0,0,24,0,0,24,24,3.00810359
20900,29.2784805,-96.2296745,26900,39.74867,-86.2123823,private,11,0,35,0,0,46,46,13,0,24,0,0,37,37,3.01620718
49740,32.7739424,-113.910905,18260,36.2772512,-85.4685013,private,0,0,0,0,0,0,0,12,0,12,0,0,24,24,3.00810359
49740,32.7739424,-113.910905,14010,40.4945594,-88.8445391,private,0,15,0,0,15,0,15,0,12,12,0,12,12,24,3.00810359
31080,34.1087033,-118.1827533,32580,26.3963839,-98.18099,private,0,0,45,0,0,45,45,0,0,82,0,0,82,82,3.044258068
41860,37.7737185,-122.2744317,37860,30.6554013,-87.1618275,private,0,0,13,0,0,13,13,0,0,24,0,0,24,24,3.00810359
41860,37.7737185,-122.2744317,32820,35.0244194,-89.8719712,private,0,0,21,0,0,21,21,0,0,35,0,0,35,35,3.014960474
42660,47.4905993,-121.833996,29200,40.4821533,-87.0171117,private,0,0,25,0,0,25,25,0,0,38,0,0,38,38,3.016830533
42660,47.4905993,-121.833996,32580,26.3963839,-98.18099,private,0,0,0,0,0,0,0,12,0,39,0,0,51,51,3.024934123
42660,47.4905993,-121.833996,44140,42.3648332,-72.6194063,private,0,0,21,0,0,21,21,0,0,24,0,0,24,24,3.00810359
42660,47.4905993,-121.833996,25540,41.7186503,-72.5739191,private,0,0,40,0,0,40,40,0,0,35,0,0,35,35,3.014960474
42660,47.4905993,-121.833996,25420,40.335915,-77.0504897,private,0,0,15,0,0,15,15,0,0,46,0,0,46,46,3.021817358
14460,42.517606,-71.0219925,36300,44.4881125,-75.074311,private,0,0,23,0,0,23,23,0,0,17,0,0,17,17,3.003740118
14460,42.517606,-71.0219925,45220,30.3864255,-84.2804096,private,0,0,23,0,0,23,23,0,0,22,0,0,22,22,3.006856884
35620,40.77493,-73.873758,23420,36.7610058,-119.6550193,private,0,0,53,0,0,53,53,0,0,47,0,0,47,47,3.022440711
37980,39.8949576,-75.3119824,30460,38.1028763,-84.4385451,private,0,0,23,0,0,23,23,0,0,12,0,0,12,12,3.000623353
47900,38.7982054,-77.4868816,32580,26.3963839,-98.18099,private,0,0,23,0,0,23,23,0,0,23,0,0,23,23,3.007480237
19100,32.8491708,-96.9704894,17380,33.7991391,-90.8841199,private,0,0,38,0,0,38,38,0,0,27,0,0,27,27,3.009973649
26420,29.7495926,-95.3536422,44180,37.3608699,-93.1802617,private,0,0,73,0,0,73,73,0,0,35,0,0,35,35,3.014960474
38060,33.1857653,-112.0678624,24660,36.0252039,-79.7926333,private,0,0,66,0,0,66,66,0,0,35,0,0,35,35,3.014960474
38060,33.1857653,-112.0678624,31700,42.9115317,-71.7230554,private,11,0,44,0,0,55,55,0,0,38,0,0,38,38,3.016830533
38060,33.1857653,-112.0678624,16140,42.039492,-94.8676471,private,0,24,11,0,24,11,35,0,12,0,0,12,0,12,3.000623353
49740,32.7739424,-113.910905,39100,41.5752737,-74.0338729,private,0,12,11,0,12,11,23,0,0,11,0,0,11,11,3
31080,34.1087033,-118.1827533,12940,30.5187808,-91.1255901,private,0,0,23,0,0,23,23,0,0,44,0,0,44,44,3.020570651
43220,47.3541257,-123.1738498,33460,45.096664,-93.275361,private,0,0,58,0,0,58,58,0,0,55,0,0,55,55,3.027427535
43220,47.3541257,-123.1738498,31460,37.2098213,-119.7498023,private,0,0,23,0,0,23,23,0,0,21,0,0,21,21,3.006233531
43220,47.3541257,-123.1738498,23420,36.7610058,-119.6550193,private,0,0,23,0,0,23,23,0,0,16,0,0,16,16,3.003116765
14460,42.517606,-71.0219925,40220,37.2862262,-79.9469346,private,0,0,18,0,0,18,18,0,0,23,0,0,23,23,3.007480237
35620,40.77493,-73.873758,48620,37.637896,-97.2462875,private,0,0,0,0,0,0,0,0,0,34,0,0,34,34,3.014337121
35620,40.77493,-73.873758,19780,41.5770501,-93.7597124,private,0,0,12,0,0,12,12,0,0,62,0,0,62,62,3.031791007
37980,39.8949576,-75.3119824,25720,40.6913977,-111.0527658,private,11,0,13,0,0,24,24,0,11,35,0,11,35,46,3.021817358
37980,39.8949576,-75.3119824,45220,30.3864255,-84.2804096,private,0,0,14,0,0,14,14,0,0,23,0,0,23,23,3.007480237
37980,39.8949576,-75.3119824,36420,35.4309676,-97.5069659,private,0,0,0,0,0,0,0,0,0,35,0,0,35,35,3.014960474
37980,39.8949576,-75.3119824,17820,38.8455072,-104.6387277,private,0,0,35,0,0,35,35,0,0,42,0,0,42,42,3.019323945
47900,38.7982054,-77.4868816,46140,36.2544287,-96.1773294,private,0,0,0,0,0,0,0,0,0,36,0,0,36,36,3.015583827
47900,38.7982054,-77.4868816,49740,32.7739424,-113.910905,private,0,0,14,0,0,14,14,0,0,23,0,0,23,23,3.007480237
47900,38.7982054,-77.4868816,10540,44.4888982,-122.5372084,private,0,0,19,0,0,19,19,0,0,23,0,0,23,23,3.007480237
12060,33.693728,-84.3999113,19780,41.5770501,-93.7597124,private,0,0,16,0,0,16,16,0,0,50,0,0,50,50,3.02431077
33460,45.096664,-93.275361,16580,40.1029885,-88.3185039,private,0,0,30,0,0,30,30,0,0,45,0,0,45,45,3.021194004
33460,45.096664,-93.275361,46140,36.2544287,-96.1773294,private,0,0,51,0,0,51,51,0,0,89,0,0,89,89,3.04862154
19100,32.8491708,-96.9704894,32780,42.4116214,-122.6756106,private,0,0,0,0,0,0,0,0,0,39,0,0,39,39,3.017453886
26420,29.7495926,-95.3536422,49180,36.0788515,-80.3450642,private,0,0,13,0,0,13,13,0,0,37,0,0,37,37,3.01620718
20900,29.2784805,-96.2296745,16860,35.0493612,-85.3611582,private,0,0,0,0,0,0,0,11,0,12,0,0,23,23,3.007480237
20900,29.2784805,-96.2296745,11100,35.2478969,-101.9086384,private,0,0,15,0,0,15,15,11,0,23,0,0,34,34,3.014337121
38060,33.1857653,-112.0678624,40220,37.2862262,-79.9469346,private,0,0,28,0,0,28,28,0,0,39,0,0,39,39,3.017453886
38060,33.1857653,-112.0678624,42460,34.764114,-85.9800556,private,0,0,11,0,0,11,11,12,0,23,0,0,35,35,3.014960474
38060,33.1857653,-112.0678624,26620,34.7832617,-86.7348706,private,0,0,0,0,0,0,0,0,0,37,0,0,37,37,3.01620718
31080,34.1087033,-118.1827533,10580,42.7879202,-73.9423479,private,0,0,13,0,0,13,13,0,0,23,0,0,23,23,3.007480237
31080,34.1087033,-118.1827533,23540,29.4807065,-82.6274667,private,0,0,14,0,0,14,14,0,0,23,0,0,23,23,3.007480237
31080,34.1087033,-118.1827533,24340,43.0375977,-85.7781669,private,0,0,0,0,0,0,0,0,0,38,0,0,38,38,3.016830533
31080,34.1087033,-118.1827533,19780,41.5770501,-93.7597124,private,0,0,24,0,0,24,24,0,0,56,0,0,56,56,3.028050888
31080,34.1087033,-118.1827533,36260,41.276061,-113.126226,private,0,0,50,0,0,50,50,0,0,102,0,0,102,102,3.05672513
41860,37.7737185,-122.2744317,24020,43.4404503,-73.6367573,private,0,0,13,0,0,13,13,0,0,23,0,0,23,23,3.007480237
42660,47.4905993,-121.833996,24540,40.555961,-104.383666,private,0,0,13,0,0,13,13,0,0,23,0,0,23,23,3.007480237
34580,48.4932917,-121.8157703,14460,42.517606,-71.0219925,private,0,0,30,0,0,30,30,0,0,23,0,0,23,23,3.007480237
34580,48.4932917,-121.8157703,11460,42.2522168,-83.8434233,private,0,0,17,0,0,17,17,0,0,23,0,0,23,23,3.007480237
34580,48.4932917,-121.8157703,30300,46.2516957,-116.9250166,private,0,0,0,0,0,0,0,0,0,23,0,0,23,23,3.007480237
43220,47.3541257,-123.1738498,26900,39.74867,-86.2123823,private,0,0,0,0,0,0,0,0,0,23,0,0,23,23,3.007480237
43220,47.3541257,-123.1738498,13940,43.2163568,-112.3992058,private,11,0,0,0,0,11,11,0,0,23,0,0,23,23,3.007480237
14460,42.517606,-71.0219925,40700,43.2863277,-123.154476,private,0,0,22,0,0,22,22,0,0,20,0,0,20,20,3.005610178
35620,40.77493,-73.873758,43900,34.9332708,-81.9910522,private,0,0,40,0,0,40,40,0,0,51,0,0,51,51,3.024934123
47900,38.7982054,-77.4868816,45060,43.0065163,-76.1961336,private,0,0,33,0,0,33,33,0,0,29,0,0,29,29,3.011220355
47900,38.7982054,-77.4868816,49620,39.9217514,-76.7288887,private,0,0,22,0,0,22,22,0,0,28,0,0,28,28,3.010597002
12060,33.693728,-84.3999113,45060,43.0065163,-76.1961336,private,0,0,57,0,0,57,57,0,0,59,0,0,59,59,3.029920947
12060,33.693728,-84.3999113,48620,37.637896,-97.2462875,private,0,0,54,0,0,54,54,0,0,32,0,0,32,32,3.013090415
33100,26.1018281,-80.4787552,21020,36.1968134,-76.3426012,private,11,0,11,0,0,22,22,0,0,14,0,0,14,14,3.001870059
33460,45.096664,-93.275361,10140,47.1137324,-123.8267349,private,0,0,40,0,0,40,40,0,0,31,0,0,31,31,3.012467061
33460,45.096664,-93.275361,33540,47.0272632,-113.8926911,private,0,0,40,0,0,40,40,0,0,37,0,0,37,37,3.01620718
33460,45.096664,-93.275361,21580,36.5096687,-106.6939829,private,0,0,22,0,0,22,22,0,0,37,0,0,37,37,3.01620718
16980,41.8235214,-87.8282967,26620,34.7832617,-86.7348706,private,0,0,22,0,0,22,22,0,0,17,0,0,17,17,3.003740118
16980,41.8235214,-87.8282967,45460,39.4784006,-87.3111315,private,0,0,34,0,0,34,34,0,0,31,0,0,31,31,3.012467061
16980,41.8235214,-87.8282967,31860,44.1548096,-94.1478013,private,0,0,22,0,0,22,22,0,0,13,0,0,13,13,3.001246706
19100,32.8491708,-96.9704894,14500,40.0949699,-105.3976911,private,0,0,35,0,0,35,35,0,0,40,0,0,40,40,3.018077239
26420,29.7495926,-95.3536422,40220,37.2862262,-79.9469346,private,0,0,22,0,0,22,22,0,0,20,0,0,20,20,3.005610178
26420,29.7495926,-95.3536422,40340,43.9496362,-92.3360701,private,0,0,22,0,0,22,22,0,0,18,0,0,18,18,3.004363472
31080,34.1087033,-118.1827533,28020,42.2462657,-85.5328544,private,0,0,22,0,0,22,22,0,0,32,0,0,32,32,3.013090415
41860,37.7737185,-122.2744317,37340,28.2983112,-80.7003334,private,0,0,37,0,0,37,37,0,0,41,0,0,41,41,3.018700592
43220,47.3541257,-123.1738498,13740,45.6371402,-108.8323611,private,0,0,35,0,0,35,35,0,0,32,0,0,32,32,3.013090415
14460,42.517606,-71.0219925,12100,39.4693555,-74.6337591,private,0,0,14,0,0,14,14,0,0,22,0,0,22,22,3.006856884
14460,42.517606,-71.0219925,33700,37.5623162,-121.0028311,private,0,0,12,0,0,12,12,0,0,22,0,0,22,22,3.006856884
35620,40.77493,-73.873758,17660,47.6759658,-116.6959222,private,0,0,0,0,0,0,0,0,0,34,0,0,34,34,3.014337121
35620,40.77493,-73.873758,12260,33.4603713,-81.9828327,private,0,0,47,0,0,47,47,0,0,114,0,0,114,114,3.064205367
35620,40.77493,-73.873758,16860,35.0493612,-85.3611582,private,0,0,0,0,0,0,0,0,0,64,0,0,64,64,3.033037713
37980,39.8949576,-75.3119824,49340,42.2173112,-71.9255354,private,0,0,38,0,0,38,38,0,0,64,0,0,64,64,3.033037713
37980,39.8949576,-75.3119824,28740,41.9472124,-74.2654582,private,0,0,15,0,0,15,15,0,0,22,0,0,22,22,3.006856884
37980,39.8949576,-75.3119824,24020,43.4404503,-73.6367573,private,0,0,12,0,0,12,12,0,0,22,0,0,22,22,3.006856884
37980,39.8949576,-75.3119824,43900,34.9332708,-81.9910522,private,0,0,18,0,0,18,18,0,0,22,0,0,22,22,3.006856884
47900,38.7982054,-77.4868816,39100,41.5752737,-74.0338729,private,0,0,27,0,0,27,27,0,0,38,0,0,38,38,3.016830533
47900,38.7982054,-77.4868816,10580,42.7879202,-73.9423479,private,0,0,33,0,0,33,33,0,0,36,0,0,36,36,3.015583827
47900,38.7982054,-77.4868816,19430,39.8288538,-84.1418129,private,0,0,15,0,0,15,15,0,0,22,0,0,22,22,3.006856884
47900,38.7982054,-77.4868816,42020,35.3852242,-120.4475445,private,0,0,11,0,0,11,11,0,0,22,0,0,22,22,3.006856884
12060,33.693728,-84.3999113,39740,40.4139565,-75.9268598,private,0,0,25,0,0,25,25,0,0,45,0,0,45,45,3.021194004
33100,26.1018281,-80.4787552,29060,43.5191091,-71.4253661,private,0,30,0,0,30,0,30,0,22,0,0,22,0,22,3.006856884
33460,45.096664,-93.275361,28780,27.1139432,-97.5685077,private,0,34,0,0,34,0,34,0,22,0,0,22,0,22,3.006856884
16980,41.8235214,-87.8282967,37500,36.1206072,-90.5663459,private,0,0,0,0,0,0,0,0,0,34,0,0,34,34,3.014337121
16980,41.8235214,-87.8282967,17020,39.6659588,-121.6019188,private,0,0,0,0,0,0,0,0,0,22,0,0,22,22,3.006856884
19100,32.8491708,-96.9704894,45940,40.2825026,-74.703724,private,0,0,44,0,0,44,44,0,0,22,0,0,22,22,3.006856884
19100,32.8491708,-96.9704894,25420,40.335915,-77.0504897,private,0,0,26,0,0,26,26,0,0,50,0,0,50,50,3.02431077
19100,32.8491708,-96.9704894,19430,39.8288538,-84.1418129,private,0,0,54,0,0,54,54,0,0,50,0,0,50,50,3.02431077
26420,29.7495926,-95.3536422,25980,31.7787881,-81.5764801,private,0,0,0,0,0,0,0,0,0,22,0,0,22,22,3.006856884
26420,29.7495926,-95.3536422,33860,32.3656313,-86.4045848,private,0,0,22,0,0,22,22,0,0,37,0,0,37,37,3.01620718
49740,32.7739424,-113.910905,23660,40.9309446,-90.2137921,private,0,11,0,0,11,0,11,11,11,0,0,11,11,22,3.006856884
31080,34.1087033,-118.1827533,49340,42.2173112,-71.9255354,private,0,0,28,0,0,28,28,0,0,51,0,0,51,51,3.024934123
31080,34.1087033,-118.1827533,29620,42.7712334,-84.4960294,private,0,0,12,0,0,12,12,0,0,43,0,0,43,43,3.019947298
31080,34.1087033,-118.1827533,27220,44.048662,-110.426087,private,0,0,0,0,0,0,0,0,0,22,0,0,22,22,3.006856884
41860,37.7737185,-122.2744317,24860,34.6837085,-82.4134227,private,0,0,24,0,0,24,24,0,0,40,0,0,40,40,3.018077239
41860,37.7737185,-122.2744317,18500,42.2667252,-77.3855253,private,0,0,26,0,0,26,26,0,0,37,0,0,37,37,3.01620718
41860,37.7737185,-122.2744317,13820,33.4025986,-86.7295151,private,0,0,0,0,0,0,0,0,0,22,0,0,22,22,3.006856884
41860,37.7737185,-122.2744317,28020,42.2462657,-85.5328544,private,0,0,0,0,0,0,0,0,0,34,0,0,34,34,3.014337121
42660,47.4905993,-121.833996,43900,34.9332708,-81.9910522,private,14,0,0,0,0,14,14,0,0,22,0,0,22,22,3.006856884
42660,47.4905993,-121.833996,19780,41.5770501,-93.7597124,private,0,0,34,0,0,34,34,0,0,60,0,0,60,60,3.030544301
42660,47.4905993,-121.833996,22380,35.8296919,-111.7737277,private,0,0,30,0,0,30,30,0,0,22,0,0,22,22,3.006856884
34580,48.4932917,-121.8157703,37980,39.8949576,-75.3119824,private,0,0,32,0,0,32,32,0,0,37,0,0,37,37,3.01620718
34580,48.4932917,-121.8157703,36100,29.2028047,-82.0431004,private,0,0,0,0,0,0,0,0,0,22,0,0,22,22,3.006856884
34580,48.4932917,-121.8157703,28940,36.0147907,-84.2067014,private,0,0,12,0,0,12,12,11,0,11,0,0,22,22,3.006856884
34580,48.4932917,-121.8157703,48580,42.6681095,-88.5417306,private,0,0,0,0,0,0,0,0,0,22,0,0,22,22,3.006856884
34580,48.4932917,-121.8157703,44180,37.3608699,-93.1802617,private,11,0,14,0,0,25,25,0,0,22,0,0,22,22,3.006856884
34580,48.4932917,-121.8157703,36540,41.2904587,-95.9999701,private,0,0,12,0,0,12,12,0,0,22,0,0,22,22,3.006856884
34580,48.4932917,-121.8157703,22220,36.1163935,-94.0795449,private,0,0,13,0,0,13,13,0,0,22,0,0,22,22,3.006856884
14460,42.517606,-71.0219925,22180,35.1559863,-78.93185,private,0,0,21,0,0,21,21,0,0,19,0,0,19,19,3.004986825
14460,42.517606,-71.0219925,17900,34.0775845,-81.0378453,private,0,0,32,0,0,32,32,0,0,36,0,0,36,36,3.015583827
14460,42.517606,-71.0219925,10420,41.1466395,-81.3501104,private,0,0,21,0,0,21,21,0,0,17,0,0,17,17,3.003740118
37980,39.8949576,-75.3119824,40220,37.2862262,-79.9469346,private,0,0,37,0,0,37,37,0,0,30,0,0,30,30,3.011843708
37980,39.8949576,-75.3119824,34580,48.4932917,-121.8157703,private,0,0,32,0,0,32,32,0,0,41,0,0,41,41,3.018700592
12060,33.693728,-84.3999113,14010,40.4945594,-88.8445391,private,0,0,21,0,0,21,21,0,0,17,0,0,17,17,3.003740118
16980,41.8235214,-87.8282967,44260,33.5146172,-89.0775079,private,0,0,21,0,0,21,21,0,0,32,0,0,32,32,3.013090415
16980,41.8235214,-87.8282967,47940,42.5367962,-92.471608,private,0,0,32,0,0,32,32,0,0,18,0,0,18,18,3.004363472
26420,29.7495926,-95.3536422,25420,40.335915,-77.0504897,private,0,0,33,0,0,33,33,0,0,32,0,0,32,32,3.013090415
26420,29.7495926,-95.3536422,10900,40.7893392,-75.398158,private,0,0,21,0,0,21,21,0,0,21,0,0,21,21,3.006233531
26420,29.7495926,-95.3536422,10540,44.4888982,-122.5372084,private,0,0,21,0,0,21,21,0,0,18,0,0,18,18,3.004363472
38060,33.1857653,-112.0678624,15940,40.7110505,-81.261468,private,0,0,21,0,0,21,21,0,0,33,0,0,33,33,3.013713768
42660,47.4905993,-121.833996,39660,44.3154852,-102.7683833,private,0,0,35,0,0,35,35,0,0,37,0,0,37,37,3.01620718
14460,42.517606,-71.0219925,28020,42.2462657,-85.5328544,private,0,0,15,0,0,15,15,0,0,21,0,0,21,21,3.006233531
35620,40.77493,-73.873758,15140,35.5866782,-89.2826913,private,0,0,12,0,0,12,12,0,0,35,0,0,35,35,3.014960474
35620,40.77493,-73.873758,30780,34.7557726,-92.4005889,private,0,0,13,0,0,13,13,0,0,35,0,0,35,35,3.014960474
35620,40.77493,-73.873758,39150,34.631071,-112.5772247,private,0,0,0,0,0,0,0,0,0,40,0,0,40,40,3.018077239
35620,40.77493,-73.873758,39900,40.5007953,-119.7311608,private,0,0,0,0,0,0,0,0,0,40,0,0,40,40,3.018077239
47900,38.7982054,-77.4868816,44300,40.9091275,-77.8478769,private,0,0,17,0,0,17,17,0,0,21,0,0,21,21,3.006233531
47900,38.7982054,-77.4868816,35900,36.2088833,-81.1660949,private,0,0,0,0,0,0,0,0,0,21,0,0,21,21,3.006233531
47900,38.7982054,-77.4868816,24340,43.0375977,-85.7781669,private,0,0,0,0,0,0,0,0,0,21,0,0,21,21,3.006233531
47900,38.7982054,-77.4868816,48580,42.6681095,-88.5417306,private,0,0,0,0,0,0,0,0,0,21,0,0,21,21,3.006233531
47900,38.7982054,-77.4868816,40340,43.9496362,-92.3360701,private,0,0,11,0,0,11,11,0,0,21,0,0,21,21,3.006233531
12060,33.693728,-84.3999113,29980,35.2204764,-87.396546,private,0,0,12,0,0,12,12,0,0,21,0,0,21,21,3.006233531
33100,26.1018281,-80.4787552,22840,34.460929,-85.803992,private,0,0,0,0,0,0,0,0,0,21,0,0,21,21,3.006233531
33460,45.096664,-93.275361,23620,33.6391964,-97.2103433,private,0,0,28,0,0,28,28,16,0,34,0,0,50,50,3.02431077
33460,45.096664,-93.275361,39900,40.5007953,-119.7311608,private,0,0,0,0,0,0,0,0,0,21,0,0,21,21,3.006233531
16980,41.8235214,-87.8282967,45860,41.7918833,-73.2354042,private,0,0,25,0,0,25,25,0,0,21,0,0,21,21,3.006233531
16980,41.8235214,-87.8282967,25420,40.335915,-77.0504897,private,0,0,34,0,0,34,34,0,0,21,0,0,21,21,3.006233531
16980,41.8235214,-87.8282967,39740,40.4139565,-75.9268598,private,0,0,0,0,0,0,0,0,0,21,0,0,21,21,3.006233531
16980,41.8235214,-87.8282967,25060,30.4801526,-88.9992972,private,0,0,31,0,0,31,31,0,0,35,0,0,35,35,3.014960474
16980,41.8235214,-87.8282967,23340,41.5770082,-96.6458526,private,0,0,30,0,0,30,30,0,0,21,0,0,21,21,3.006233531
19100,32.8491708,-96.9704894,31700,42.9115317,-71.7230554,private,0,0,30,0,0,30,30,0,0,47,0,0,47,47,3.022440711
19100,32.8491708,-96.9704894,34740,43.2892579,-86.751892,private,0,0,30,0,0,30,30,0,0,21,0,0,21,21,3.006233531
26420,29.7495926,-95.3536422,15620,44.3287385,-85.3264287,private,0,14,0,0,14,0,14,0,21,0,0,21,0,21,3.006233531
20900,29.2784805,-96.2296745,41940,36.9084718,-121.3713721,private,0,0,31,0,0,31,31,0,0,40,0,0,40,40,3.018077239
38060,33.1857653,-112.0678624,41540,38.3995211,-75.4782615,private,0,0,15,0,0,15,15,0,0,33,0,0,33,33,3.013713768
38060,33.1857653,-112.0678624,30780,34.7557726,-92.4005889,private,0,0,37,0,0,37,37,0,0,88,0,0,88,88,3.047998187
31080,34.1087033,-118.1827533,15140,35.5866782,-89.2826913,private,0,0,45,0,0,45,45,0,0,21,0,0,21,21,3.006233531
31080,34.1087033,-118.1827533,34740,43.2892579,-86.751892,private,0,0,11,0,0,11,11,0,0,21,0,0,21,21,3.006233531
31080,34.1087033,-118.1827533,49420,46.4565581,-120.7401446,private,0,0,48,0,0,48,48,0,0,44,0,0,44,44,3.020570651
41860,37.7737185,-122.2744317,15380,43.0443711,-78.7773351,private,0,0,31,0,0,31,31,0,0,51,0,0,51,51,3.024934123
42660,47.4905993,-121.833996,33660,30.9715095,-88.20787,private,0,0,0,0,0,0,0,0,0,21,0,0,21,21,3.006233531
42660,47.4905993,-121.833996,10420,41.1466395,-81.3501104,private,0,0,0,0,0,0,0,0,0,46,0,0,46,46,3.021817358
42660,47.4905993,-121.833996,40380,43.148038,-77.5232575,private,0,0,26,0,0,26,26,0,0,33,0,0,33,33,3.013713768
42660,47.4905993,-121.833996,23540,29.4807065,-82.6274667,private,0,0,12,0,0,12,12,0,0,21,0,0,21,21,3.006233531
42660,47.4905993,-121.833996,30460,38.1028763,-84.4385451,private,0,0,11,0,0,11,11,0,0,40,0,0,40,40,3.018077239
42660,47.4905993,-121.833996,29620,42.7712334,-84.4960294,private,0,0,14,0,0,14,14,0,0,33,0,0,33,33,3.013713768
42660,47.4905993,-121.833996,16580,40.1029885,-88.3185039,private,0,0,18,0,0,18,18,0,0,40,0,0,40,40,3.018077239
34580,48.4932917,-121.8157703,19820,42.7218478,-83.2008463,private,0,0,30,0,0,30,30,0,0,21,0,0,21,21,3.006233531
34580,48.4932917,-121.8157703,24300,39.019524,-108.4605707,private,0,0,0,0,0,0,0,0,0,21,0,0,21,21,3.006233531
43220,47.3541257,-123.1738498,21580,36.5096687,-106.6939829,private,0,0,17,0,0,17,17,0,0,21,0,0,21,21,3.006233531
14460,42.517606,-71.0219925,36420,35.4309676,-97.5069659,private,0,0,20,0,0,20,20,0,0,33,0,0,33,33,3.013713768
12060,33.693728,-84.3999113,40420,42.331183,-89.0429139,private,0,0,32,0,0,32,32,0,0,11,0,0,11,11,3
33460,45.096664,-93.275361,23060,41.1131166,-85.2177047,private,0,0,20,0,0,20,20,0,0,12,0,0,12,12,3.000623353
33460,45.096664,-93.275361,28660,31.2027301,-97.7896384,private,0,0,51,0,0,51,51,0,0,39,0,0,39,39,3.017453886
33460,45.096664,-93.275361,21340,31.527394,-105.5213326,private,0,0,31,0,0,31,31,0,0,12,0,0,12,12,3.000623353
16980,41.8235214,-87.8282967,36900,41.0312751,-92.4094658,private,0,0,20,0,0,20,20,0,0,17,0,0,17,17,3.003740118
19100,32.8491708,-96.9704894,16580,40.1029885,-88.3185039,private,0,0,36,0,0,36,36,0,0,20,0,0,20,20,3.005610178
19100,32.8491708,-96.9704894,30700,40.8174581,-96.8687434,private,0,0,20,0,0,20,20,0,0,18,0,0,18,18,3.004363472
26420,29.7495926,-95.3536422,34780,35.6175506,-95.3839106,private,0,0,37,0,0,37,37,0,0,24,0,0,24,24,3.00810359
20900,29.2784805,-96.2296745,31140,38.3058381,-85.6816455,private,0,0,20,0,0,20,20,0,0,14,0,0,14,14,3.001870059
38060,33.1857653,-112.0678624,11100,35.2478969,-101.9086384,private,0,0,20,0,0,20,20,0,0,46,0,0,46,46,3.021817358
38060,33.1857653,-112.0678624,49340,42.2173112,-71.9255354,private,0,0,20,0,0,20,20,0,0,18,0,0,18,18,3.004363472
38060,33.1857653,-112.0678624,10900,40.7893392,-75.398158,private,0,0,31,0,0,31,31,0,0,34,0,0,34,34,3.014337121
38060,33.1857653,-112.0678624,30620,40.7716274,-84.1061032,private,0,0,20,0,0,20,20,0,0,20,0,0,20,20,3.005610178
38060,33.1857653,-112.0678624,30980,32.4316457,-94.6848326,private,0,0,20,0,0,20,20,0,0,24,0,0,24,24,3.00810359
49740,32.7739424,-113.910905,40060,37.4113241,-77.4418164,private,0,0,50,0,0,50,50,0,0,20,0,0,20,20,3.005610178
42660,47.4905993,-121.833996,16820,37.9490837,-78.5932062,private,0,0,33,0,0,33,33,0,0,20,0,0,20,20,3.005610178
14460,42.517606,-71.0219925,28740,41.9472124,-74.2654582,private,0,0,17,0,0,17,17,0,0,20,0,0,20,20,3.005610178
14460,42.517606,-71.0219925,19430,39.8288538,-84.1418129,private,0,0,24,0,0,24,24,0,0,32,0,0,32,32,3.013090415
35620,40.77493,-73.873758,33660,30.9715095,-88.20787,private,0,0,0,0,0,0,0,0,0,36,0,0,36,36,3.015583827
37980,39.8949576,-75.3119824,13820,33.4025986,-86.7295151,private,0,0,11,0,0,11,11,0,0,20,0,0,20,20,3.005610178
47900,38.7982054,-77.4868816,49340,42.2173112,-71.9255354,private,0,0,12,0,0,12,12,0,0,47,0,0,47,47,3.022440711
12060,33.693728,-84.3999113,38500,41.3250032,-86.2690363,private,0,0,18,0,0,18,18,0,0,35,0,0,35,35,3.014960474
12060,33.693728,-84.3999113,29620,42.7712334,-84.4960294,private,0,0,61,0,0,61,61,0,0,60,0,0,60,60,3.030544301
33100,26.1018281,-80.4787552,16820,37.9490837,-78.5932062,private,0,0,30,0,0,30,30,0,0,20,0,0,20,20,3.005610178
33100,26.1018281,-80.4787552,24340,43.0375977,-85.7781669,private,0,13,30,0,13,30,43,0,0,47,0,0,47,47,3.022440711
33100,26.1018281,-80.4787552,12940,30.5187808,-91.1255901,private,0,0,30,0,0,30,30,0,0,31,0,0,31,31,3.012467061
33460,45.096664,-93.275361,15380,43.0443711,-78.7773351,private,0,0,32,0,0,32,32,0,0,20,0,0,20,20,3.005610178
33460,45.096664,-93.275361,18500,42.2667252,-77.3855253,private,0,0,12,0,0,12,12,0,0,20,0,0,20,20,3.005610178
33460,45.096664,-93.275361,45220,30.3864255,-84.2804096,private,0,0,0,0,0,0,0,0,0,20,0,0,20,20,3.005610178
33460,45.096664,-93.275361,30700,40.8174581,-96.8687434,private,0,0,45,0,0,45,45,0,0,55,0,0,55,55,3.027427535
16980,41.8235214,-87.8282967,21500,42.1179519,-80.0963858,private,0,0,0,0,0,0,0,0,0,20,0,0,20,20,3.005610178
16980,41.8235214,-87.8282967,44300,40.9091275,-77.8478769,private,0,0,18,0,0,18,18,0,0,20,0,0,20,20,3.005610178
16980,41.8235214,-87.8282967,15680,38.2202894,-76.5303837,private,0,0,0,0,0,0,0,0,0,20,0,0,20,20,3.005610178
16980,41.8235214,-87.8282967,35900,36.2088833,-81.1660949,private,0,0,15,0,0,15,15,0,0,52,0,0,52,52,3.025557476
16980,41.8235214,-87.8282967,39500,40.0271652,-91.3898384,private,0,0,46,0,0,46,46,0,0,46,0,0,46,46,3.021817358
19100,32.8491708,-96.9704894,15680,38.2202894,-76.5303837,private,0,0,11,0,0,11,11,0,0,20,0,0,20,20,3.005610178
19100,32.8491708,-96.9704894,17660,47.6759658,-116.6959222,private,0,0,0,0,0,0,0,0,0,20,0,0,20,20,3.005610178
26420,29.7495926,-95.3536422,12700,41.7990145,-70.2118803,private,0,15,0,0,15,0,15,0,20,0,0,20,0,20,3.005610178
26420,29.7495926,-95.3536422,39100,41.5752737,-74.0338729,private,0,0,0,0,0,0,0,0,0,33,0,0,33,33,3.013713768
26420,29.7495926,-95.3536422,42340,32.1091533,-81.2731066,private,0,0,12,0,0,12,12,0,0,20,0,0,20,20,3.005610178
26420,29.7495926,-95.3536422,17380,33.7991391,-90.8841199,private,0,0,0,0,0,0,0,0,0,20,0,0,20,20,3.005610178
26420,29.7495926,-95.3536422,39900,40.5007953,-119.7311608,private,0,0,30,0,0,30,30,0,0,31,0,0,31,31,3.012467061
26420,29.7495926,-95.3536422,44060,48.091618,-117.663472,private,0,0,27,0,0,27,27,0,0,31,0,0,31,31,3.012467061
20900,29.2784805,-96.2296745,41620,40.5728869,-112.9532527,private,0,0,11,0,0,11,11,0,0,20,0,0,20,20,3.005610178
38060,33.1857653,-112.0678624,49660,41.23646,-80.5617836,private,0,0,26,0,0,26,26,0,0,56,0,0,56,56,3.028050888
38060,33.1857653,-112.0678624,21700,40.7066554,-123.9261757,private,0,0,0,0,0,0,0,0,0,31,0,0,31,31,3.012467061
49740,32.7739424,-113.910905,35380,29.805532,-89.7013821,private,0,0,11,0,0,11,11,0,0,20,0,0,20,20,3.005610178
31080,34.1087033,-118.1827533,25420,40.335915,-77.0504897,private,0,0,11,0,0,11,11,0,0,31,0,0,31,31,3.012467061
31080,34.1087033,-118.1827533,45220,30.3864255,-84.2804096,private,0,0,15,0,0,15,15,0,0,20,0,0,20,20,3.005610178
31080,34.1087033,-118.1827533,10420,41.1466395,-81.3501104,private,0,0,35,0,0,35,35,0,0,48,0,0,48,48,3.023064064
31080,34.1087033,-118.1827533,40340,43.9496362,-92.3360701,private,0,0,17,0,0,17,17,0,0,20,0,0,20,20,3.005610178
31080,34.1087033,-118.1827533,17860,38.9864864,-92.5851888,private,0,0,11,0,0,11,11,0,0,20,0,0,20,20,3.005610178
31080,34.1087033,-118.1827533,36100,29.2028047,-82.0431004,private,0,0,12,0,0,12,12,0,0,36,0,0,36,36,3.015583827
41860,37.7737185,-122.2744317,36540,41.2904587,-95.9999701,private,0,0,29,0,0,29,29,0,0,33,0,0,33,33,3.013713768
41860,37.7737185,-122.2744317,41980,18.2944526,-66.0368437,private,0,0,12,0,0,12,12,0,0,20,0,0,20,20,3.005610178
41860,37.7737185,-122.2744317,10900,40.7893392,-75.398158,private,0,0,12,0,0,12,12,0,0,20,0,0,20,20,3.005610178
41860,37.7737185,-122.2744317,48900,34.4260331,-77.889634,private,0,0,16,0,0,16,16,0,0,20,0,0,20,20,3.005610178
41860,37.7737185,-122.2744317,21340,31.527394,-105.5213326,private,0,0,26,0,0,26,26,0,0,36,0,0,36,36,3.015583827
42660,47.4905993,-121.833996,28940,36.0147907,-84.2067014,private,0,0,13,0,0,13,13,0,0,59,0,0,59,59,3.029920947
34580,48.4932917,-121.8157703,21580,36.5096687,-106.6939829,private,0,0,14,0,0,14,14,0,0,20,0,0,20,20,3.005610178
43220,47.3541257,-123.1738498,14460,42.517606,-71.0219925,private,0,0,11,0,0,11,11,0,0,20,0,0,20,20,3.005610178
43220,47.3541257,-123.1738498,30300,46.2516957,-116.9250166,private,0,0,0,0,0,0,0,0,0,20,0,0,20,20,3.005610178
14460,42.517606,-71.0219925,39740,40.4139565,-75.9268598,private,0,0,19,0,0,19,19,0,0,30,0,0,30,30,3.011843708
37980,39.8949576,-75.3119824,49660,41.23646,-80.5617836,private,0,0,19,0,0,19,19,0,0,16,0,0,16,16,3.003116765
37980,39.8949576,-75.3119824,14500,40.0949699,-105.3976911,private,0,0,19,0,0,19,19,0,0,27,0,0,27,27,3.009973649
12060,33.693728,-84.3999113,46180,34.3400327,-88.6511835,private,0,0,30,0,0,30,30,0,0,14,0,0,14,14,3.001870059
12060,33.693728,-84.3999113,16300,42.0863293,-91.6311439,private,0,0,30,0,0,30,30,0,0,11,0,0,11,11,3
33460,45.096664,-93.275361,28940,36.0147907,-84.2067014,private,0,0,30,0,0,30,30,0,0,39,0,0,39,39,3.017453886
19100,32.8491708,-96.9704894,41980,18.2944526,-66.0368437,private,0,0,30,0,0,30,30,0,0,57,0,0,57,57,3.028674241
38060,33.1857653,-112.0678624,34780,35.6175506,-95.3839106,private,0,0,30,0,0,30,30,0,0,22,0,0,22,22,3.006856884
38060,33.1857653,-112.0678624,16180,39.1530598,-119.7473681,private,0,0,19,0,0,19,19,0,0,16,0,0,16,16,3.003116765
38060,33.1857653,-112.0678624,30460,38.1028763,-84.4385451,private,0,0,35,0,0,35,35,0,0,54,0,0,54,54,3.026804182
49740,32.7739424,-113.910905,10100,45.5194353,-98.7007003,private,0,19,0,0,19,0,19,0,12,0,0,12,0,12,3.000623353
31080,34.1087033,-118.1827533,29940,38.8964168,-95.2909475,private,0,0,53,0,0,53,53,0,0,34,0,0,34,34,3.014337121
31080,34.1087033,-118.1827533,35100,35.1168292,-77.0813197,private,0,0,19,0,0,19,19,0,0,26,0,0,26,26,3.009350296
41860,37.7737185,-122.2744317,23620,33.6391964,-97.2103433,private,0,0,30,0,0,30,30,0,0,13,0,0,13,13,3.001246706
42660,47.4905993,-121.833996,12020,33.943984,-83.2138965,private,0,0,19,0,0,19,19,0,0,12,0,0,12,12,3.000623353
34580,48.4932917,-121.8157703,26900,39.74867,-86.2123823,private,0,0,37,0,0,37,37,0,0,17,0,0,17,17,3.003740118
14460,42.517606,-71.0219925,35900,36.2088833,-81.1660949,private,0,0,0,0,0,0,0,0,0,19,0,0,19,19,3.004986825
14460,42.517606,-71.0219925,40340,43.9496362,-92.3360701,private,0,0,18,0,0,18,18,0,0,19,0,0,19,19,3.004986825
35620,40.77493,-73.873758,26620,34.7832617,-86.7348706,private,0,0,0,0,0,0,0,0,0,33,0,0,33,33,3.013713768
35620,40.77493,-73.873758,29200,40.4821533,-87.0171117,private,0,0,12,0,0,12,12,0,0,31,0,0,31,31,3.012467061
35620,40.77493,-73.873758,17020,39.6659588,-121.6019188,private,0,0,14,0,0,14,14,0,0,34,0,0,34,34,3.014337121
35620,40.77493,-73.873758,31420,32.8562163,-83.714305,private,0,0,15,0,0,15,15,0,0,19,0,0,19,19,3.004986825
37980,39.8949576,-75.3119824,12020,33.943984,-83.2138965,private,0,0,0,0,0,0,0,0,0,19,0,0,19,19,3.004986825
37980,39.8949576,-75.3119824,48180,31.1331137,-82.3686504,private,0,0,0,0,0,0,0,0,0,19,0,0,19,19,3.004986825
37980,39.8949576,-75.3119824,10420,41.1466395,-81.3501104,private,0,0,24,0,0,24,24,0,0,33,0,0,33,33,3.013713768
37980,39.8949576,-75.3119824,28020,42.2462657,-85.5328544,private,0,0,0,0,0,0,0,0,0,19,0,0,19,19,3.004986825
47900,38.7982054,-77.4868816,31700,42.9115317,-71.7230554,private,0,0,34,0,0,34,34,0,0,34,0,0,34,34,3.014337121
47900,38.7982054,-77.4868816,14020,39.2417362,-86.6717544,private,0,0,0,0,0,0,0,0,0,19,0,0,19,19,3.004986825
47900,38.7982054,-77.4868816,36540,41.2904587,-95.9999701,private,0,0,15,0,0,15,15,0,0,19,0,0,19,19,3.004986825
47900,38.7982054,-77.4868816,36420,35.4309676,-97.5069659,private,0,0,30,0,0,30,30,0,0,19,0,0,19,19,3.004986825
33100,26.1018281,-80.4787552,23060,41.1131166,-85.2177047,private,0,0,26,0,0,26,26,0,0,19,0,0,19,19,3.004986825
33460,45.096664,-93.275361,19340,41.3916799,-90.460076,private,0,0,26,0,0,26,26,0,0,19,0,0,19,19,3.004986825
16980,41.8235214,-87.8282967,11220,42.9008912,-74.4353575,private,0,0,17,0,0,17,17,0,0,19,0,0,19,19,3.004986825
16980,41.8235214,-87.8282967,12260,33.4603713,-81.9828327,private,0,0,17,0,0,17,17,0,0,30,0,0,30,30,3.011843708
19100,32.8491708,-96.9704894,39300,41.7068313,-71.2866369,private,0,0,42,0,0,42,42,0,0,48,0,0,48,48,3.023064064
19100,32.8491708,-96.9704894,40380,43.148038,-77.5232575,private,0,0,36,0,0,36,36,0,0,48,0,0,48,48,3.023064064
19100,32.8491708,-96.9704894,49660,41.23646,-80.5617836,private,0,0,12,0,0,12,12,0,0,19,0,0,19,19,3.004986825
19100,32.8491708,-96.9704894,29420,35.717705,-113.7496891,private,0,0,0,0,0,0,0,0,0,19,0,0,19,19,3.004986825
19100,32.8491708,-96.9704894,28060,48.3146779,-114.0542951,private,0,0,12,0,0,12,12,0,19,15,0,19,15,34,3.014337121
26420,29.7495926,-95.3536422,35100,35.1168292,-77.0813197,private,0,0,29,0,0,29,29,0,0,37,0,0,37,37,3.01620718
26420,29.7495926,-95.3536422,46180,34.3400327,-88.6511835,private,0,0,0,0,0,0,0,0,0,19,0,0,19,19,3.004986825
26420,29.7495926,-95.3536422,32940,32.4106743,-88.6619259,private,0,0,0,0,0,0,0,0,0,32,0,0,32,32,3.013090415
26420,29.7495926,-95.3536422,29620,42.7712334,-84.4960294,private,0,0,11,0,0,11,11,0,0,34,0,0,34,34,3.014337121
26420,29.7495926,-95.3536422,24300,39.019524,-108.4605707,private,0,0,14,0,0,14,14,0,0,19,0,0,19,19,3.004986825
26420,29.7495926,-95.3536422,40700,43.2863277,-123.154476,private,0,0,28,0,0,28,28,0,0,19,0,0,19,19,3.004986825
20900,29.2784805,-96.2296745,43340,32.4376822,-93.7448836,private,0,0,18,0,0,18,18,0,0,19,0,0,19,19,3.004986825
26420,29.7495926,-95.3536422,18260,36.2772512,-85.4685013,private,0,0,27,0,0,27,27,0,0,31,0,0,31,31,3.012467061
26420,29.7495926,-95.3536422,22900,35.4631192,-94.2997413,private,0,0,0,0,0,0,0,0,0,37,0,0,37,37,3.01620718
38060,33.1857653,-112.0678624,37940,40.7728833,-86.0442575,private,0,0,12,0,0,12,12,0,12,19,0,12,19,31,3.012467061
49740,32.7739424,-113.910905,37120,31.4306536,-85.609476,private,0,0,0,0,0,0,0,0,0,19,0,0,19,19,3.004986825
31080,34.1087033,-118.1827533,14010,40.4945594,-88.8445391,private,0,0,0,0,0,0,0,0,0,19,0,0,19,19,3.004986825
31080,34.1087033,-118.1827533,17780,30.7543917,-96.4885368,private,0,0,13,0,0,13,13,0,0,19,0,0,19,19,3.004986825
31080,34.1087033,-118.1827533,24540,40.555961,-104.383666,private,0,0,45,0,0,45,45,0,0,57,0,0,57,57,3.028674241
31080,34.1087033,-118.1827533,24300,39.019524,-108.4605707,private,0,0,12,0,0,12,12,0,0,34,0,0,34,34,3.014337121
41860,37.7737185,-122.2744317,43620,43.4954205,-96.9953387,private,0,0,0,0,0,0,0,0,0,19,0,0,19,19,3.004986825
42660,47.4905993,-121.833996,40220,37.2862262,-79.9469346,private,0,0,16,0,0,16,16,0,0,19,0,0,19,19,3.004986825
42660,47.4905993,-121.833996,44180,37.3608699,-93.1802617,private,0,0,38,0,0,38,38,0,0,50,0,0,50,50,3.02431077
42660,47.4905993,-121.833996,18500,42.2667252,-77.3855253,private,0,0,31,0,0,31,31,0,0,19,0,0,19,19,3.004986825
42660,47.4905993,-121.833996,30700,40.8174581,-96.8687434,private,0,0,25,0,0,25,25,0,0,19,0,0,19,19,3.004986825
34580,48.4932917,-121.8157703,14500,40.0949699,-105.3976911,private,0,0,0,0,0,0,0,0,0,19,0,0,19,19,3.004986825
34580,48.4932917,-121.8157703,39340,39.872067,-112.3590592,private,0,0,0,0,0,0,0,0,0,19,0,0,19,19,3.004986825
43220,47.3541257,-123.1738498,17780,30.7543917,-96.4885368,private,0,0,0,0,0,0,0,0,0,19,0,0,19,19,3.004986825
43220,47.3541257,-123.1738498,16220,42.9776447,-106.7682192,private,0,0,0,0,0,0,0,0,0,19,0,0,19,19,3.004986825
42660,47.4905993,-121.833996,37120,31.4306536,-85.609476,private,16,0,0,0,0,16,16,19,0,0,0,0,19,19,3.004986825
47900,38.7982054,-77.4868816,12020,33.943984,-83.2138965,private,0,0,18,0,0,18,18,0,0,15,0,0,15,15,3.002493412
47900,38.7982054,-77.4868816,23620,33.6391964,-97.2103433,private,0,0,18,0,0,18,18,0,0,12,0,0,12,12,3.000623353
12060,33.693728,-84.3999113,43620,43.4954205,-96.9953387,private,0,0,18,0,0,18,18,0,0,11,0,0,11,11,3
12060,33.693728,-84.3999113,46340,32.3770156,-95.2700409,private,0,0,18,0,0,18,18,0,0,13,0,0,13,13,3.001246706
12060,33.693728,-84.3999113,21580,36.5096687,-106.6939829,private,0,0,18,0,0,18,18,0,0,30,0,0,30,30,3.011843708
33100,26.1018281,-80.4787552,49620,39.9217514,-76.7288887,private,0,11,18,0,11,18,29,0,0,16,0,0,16,16,3.003116765
33100,26.1018281,-80.4787552,31540,43.0842941,-89.5971796,private,0,0,55,0,0,55,55,0,12,40,0,12,40,52,3.025557476
33100,26.1018281,-80.4787552,39900,40.5007953,-119.7311608,private,0,0,34,0,0,34,34,0,0,12,0,0,12,12,3.000623353
16980,41.8235214,-87.8282967,27740,36.2658223,-82.3326926,private,0,0,32,0,0,32,32,13,0,39,0,0,52,52,3.025557476
16980,41.8235214,-87.8282967,31420,32.8562163,-83.714305,private,0,0,18,0,0,18,18,0,0,18,0,0,18,18,3.004363472
16980,41.8235214,-87.8282967,42020,35.3852242,-120.4475445,private,0,0,30,0,0,30,30,0,0,18,0,0,18,18,3.004363472
19100,32.8491708,-96.9704894,23340,41.5770082,-96.6458526,private,0,0,18,0,0,18,18,0,0,11,0,0,11,11,3
38060,33.1857653,-112.0678624,45940,40.2825026,-74.703724,private,0,0,18,0,0,18,18,0,0,13,0,0,13,13,3.001246706
31080,34.1087033,-118.1827533,45060,43.0065163,-76.1961336,private,0,0,18,0,0,18,18,0,0,13,0,0,13,13,3.001246706
31080,34.1087033,-118.1827533,17900,34.0775845,-81.0378453,private,0,0,30,0,0,30,30,0,0,34,0,0,34,34,3.014337121
31080,34.1087033,-118.1827533,29200,40.4821533,-87.0171117,private,0,0,31,0,0,31,31,0,0,25,0,0,25,25,3.008726943
31080,34.1087033,-118.1827533,44180,37.3608699,-93.1802617,private,0,0,31,0,0,31,31,0,0,26,0,0,26,26,3.009350296
42660,47.4905993,-121.833996,49180,36.0788515,-80.3450642,private,0,0,18,0,0,18,18,0,0,15,0,0,15,15,3.002493412
34580,48.4932917,-121.8157703,35620,40.77493,-73.873758,private,0,0,30,0,0,30,30,0,0,15,0,0,15,15,3.002493412
43220,47.3541257,-123.1738498,18140,39.9685617,-82.8359105,private,0,0,18,0,0,18,18,11,0,0,0,0,11,11,3
14460,42.517606,-71.0219925,10380,18.3569648,-67.0078951,private,0,0,16,0,0,16,16,0,0,18,0,0,18,18,3.004363472
14460,42.517606,-71.0219925,17780,30.7543917,-96.4885368,private,0,0,11,0,0,11,11,0,0,18,0,0,18,18,3.004363472
35620,40.77493,-73.873758,12620,45.4092843,-68.666616,private,0,0,17,0,0,17,17,0,0,33,0,0,33,33,3.013713768
37980,39.8949576,-75.3119824,21500,42.1179519,-80.0963858,private,0,0,17,0,0,17,17,0,0,18,0,0,18,18,3.004363472
37980,39.8949576,-75.3119824,40700,43.2863277,-123.154476,private,0,0,16,0,0,16,16,0,0,18,0,0,18,18,3.004363472
47900,38.7982054,-77.4868816,45860,41.7918833,-73.2354042,private,0,0,13,0,0,13,13,0,0,18,0,0,18,18,3.004363472
47900,38.7982054,-77.4868816,11220,42.9008912,-74.4353575,private,0,0,0,0,0,0,0,0,0,18,0,0,18,18,3.004363472
47900,38.7982054,-77.4868816,34740,43.2892579,-86.751892,private,0,0,12,0,0,12,12,0,0,18,0,0,18,18,3.004363472
12060,33.693728,-84.3999113,11220,42.9008912,-74.4353575,private,0,0,28,0,0,28,28,0,0,30,0,0,30,30,3.011843708
12060,33.693728,-84.3999113,32940,32.4106743,-88.6619259,private,0,0,32,0,0,32,32,0,0,44,0,0,44,44,3.020570651
12060,33.693728,-84.3999113,49660,41.23646,-80.5617836,private,0,0,43,0,0,43,43,0,0,68,0,0,68,68,3.035531125
12060,33.693728,-84.3999113,15620,44.3287385,-85.3264287,private,0,12,0,0,12,0,12,0,30,11,0,30,11,41,3.018700592
12060,33.693728,-84.3999113,26380,29.3341299,-90.8436739,private,0,0,11,0,0,11,11,0,0,18,0,0,18,18,3.004363472
12060,33.693728,-84.3999113,33740,32.734255,-92.0995498,private,11,0,0,0,0,11,11,0,0,49,0,0,49,49,3.023687417
33100,26.1018281,-80.4787552,15680,38.2202894,-76.5303837,private,0,0,15,0,0,15,15,0,0,31,0,0,31,31,3.012467061
33460,45.096664,-93.275361,44020,43.3896107,-95.1960572,private,0,0,11,0,0,11,11,0,0,34,0,0,34,34,3.014337121
33460,45.096664,-93.275361,39540,42.7541215,-87.4208775,private,0,0,0,0,0,0,0,0,0,18,0,0,18,18,3.004363472
16980,41.8235214,-87.8282967,27620,38.6368854,-92.088876,private,0,0,41,0,0,41,41,0,0,42,0,0,42,42,3.019323945
16980,41.8235214,-87.8282967,45060,43.0065163,-76.1961336,private,0,0,29,0,0,29,29,0,0,35,0,0,35,35,3.014960474
16980,41.8235214,-87.8282967,33860,32.3656313,-86.4045848,private,0,0,11,0,0,11,11,0,0,40,0,0,40,40,3.018077239
16980,41.8235214,-87.8282967,17380,33.7991391,-90.8841199,private,0,0,0,0,0,0,0,0,0,18,0,0,18,18,3.004363472
16980,41.8235214,-87.8282967,14540,37.0468241,-86.3970408,private,0,0,0,0,0,0,0,0,0,32,0,0,32,32,3.013090415
16980,41.8235214,-87.8282967,49660,41.23646,-80.5617836,private,0,0,13,0,0,13,13,0,0,18,0,0,18,18,3.004363472
16980,41.8235214,-87.8282967,44060,48.091618,-117.663472,private,0,0,0,0,0,0,0,0,0,18,0,0,18,18,3.004363472
19100,32.8491708,-96.9704894,33860,32.3656313,-86.4045848,private,0,0,12,0,0,12,12,0,0,43,0,0,43,43,3.019947298
19100,32.8491708,-96.9704894,46180,34.3400327,-88.6511835,private,0,0,0,0,0,0,0,0,0,18,0,0,18,18,3.004363472
19100,32.8491708,-96.9704894,29200,40.4821533,-87.0171117,private,0,0,26,0,0,26,26,0,0,18,0,0,18,18,3.004363472
19100,32.8491708,-96.9704894,40300,42.041884,-89.3201764,private,0,0,17,0,0,17,17,0,0,18,0,0,18,18,3.004363472
19100,32.8491708,-96.9704894,46380,39.4323876,-123.4428811,private,0,0,12,0,0,12,12,0,0,31,0,0,31,31,3.012467061
26420,29.7495926,-95.3536422,36900,41.0312751,-92.4094658,private,0,0,0,0,0,0,0,0,0,18,0,0,18,18,3.004363472
26420,29.7495926,-95.3536422,10460,32.6155988,-105.7513079,private,0,0,11,0,0,11,11,0,0,18,0,0,18,18,3.004363472
20900,29.2784805,-96.2296745,27140,32.4282801,-90.2023875,private,0,0,16,0,0,16,16,0,0,31,0,0,31,31,3.012467061
38060,33.1857653,-112.0678624,41980,18.2944526,-66.0368437,private,0,0,0,0,0,0,0,0,0,18,0,0,18,18,3.004363472
38060,33.1857653,-112.0678624,14020,39.2417362,-86.6717544,private,0,0,42,0,0,42,42,0,0,35,0,0,35,35,3.014960474
49740,32.7739424,-113.910905,12700,41.7990145,-70.2118803,private,0,16,0,0,16,0,16,0,18,0,0,18,0,18,3.004363472
49740,32.7739424,-113.910905,35300,41.3497185,-72.9002033,private,0,12,0,0,12,0,12,0,0,18,0,0,18,18,3.004363472
49740,32.7739424,-113.910905,35940,41.1450798,-82.594641,private,0,0,11,0,0,11,11,0,0,18,0,0,18,18,3.004363472
31080,34.1087033,-118.1827533,35980,41.4726517,-72.1086339,private,0,0,11,0,0,11,11,0,0,18,0,0,18,18,3.004363472
31080,34.1087033,-118.1827533,27140,32.4282801,-90.2023875,private,0,0,0,0,0,0,0,0,0,18,0,0,18,18,3.004363472
31080,34.1087033,-118.1827533,30460,38.1028763,-84.4385451,private,0,0,0,0,0,0,0,0,0,18,0,0,18,18,3.004363472
31080,34.1087033,-118.1827533,45780,41.5553128,-83.5170883,private,0,0,13,0,0,13,13,0,0,18,0,0,18,18,3.004363472
31080,34.1087033,-118.1827533,29180,29.9577733,-92.0493498,private,0,0,16,0,0,16,16,0,0,18,0,0,18,18,3.004363472
31080,34.1087033,-118.1827533,33740,32.734255,-92.0995498,private,0,0,0,0,0,0,0,0,0,18,0,0,18,18,3.004363472
41860,37.7737185,-122.2744317,29060,43.5191091,-71.4253661,private,0,0,0,0,0,0,0,0,0,18,0,0,18,18,3.004363472
41860,37.7737185,-122.2744317,10580,42.7879202,-73.9423479,private,0,0,0,0,0,0,0,0,0,30,0,0,30,30,3.011843708
41860,37.7737185,-122.2744317,23540,29.4807065,-82.6274667,private,0,0,17,0,0,17,17,0,0,31,0,0,31,31,3.012467061
41860,37.7737185,-122.2744317,36420,35.4309676,-97.5069659,private,0,0,0,0,0,0,0,15,0,18,0,0,33,33,3.013713768
41860,37.7737185,-122.2744317,28420,46.3639636,-119.2540459,private,0,0,28,0,0,28,28,0,0,29,0,0,29,29,3.011220355
42660,47.4905993,-121.833996,30300,46.2516957,-116.9250166,private,0,0,0,0,0,0,0,0,0,32,0,0,32,32,3.013090415
42660,47.4905993,-121.833996,24660,36.0252039,-79.7926333,private,0,0,61,0,0,61,61,0,0,56,0,0,56,56,3.028050888
42660,47.4905993,-121.833996,19430,39.8288538,-84.1418129,private,0,0,24,0,0,24,24,0,0,18,0,0,18,18,3.004363472
34580,48.4932917,-121.8157703,35100,35.1168292,-77.0813197,private,0,0,0,0,0,0,0,0,0,18,0,0,18,18,3.004363472
34580,48.4932917,-121.8157703,11700,35.5956693,-82.6816145,private,0,0,0,0,0,0,0,0,0,18,0,0,18,18,3.004363472
34580,48.4932917,-121.8157703,24860,34.6837085,-82.4134227,private,0,0,14,0,0,14,14,0,0,18,0,0,18,18,3.004363472
34580,48.4932917,-121.8157703,36380,27.3855924,-80.8873884,private,0,0,15,0,0,15,15,0,0,18,0,0,18,18,3.004363472
34580,48.4932917,-121.8157703,34740,43.2892579,-86.751892,private,0,0,13,0,0,13,13,0,0,18,0,0,18,18,3.004363472
34580,48.4932917,-121.8157703,35380,29.805532,-89.7013821,private,0,0,23,0,0,23,23,0,0,34,0,0,34,34,3.014337121
34580,48.4932917,-121.8157703,24540,40.555961,-104.383666,private,0,0,16,0,0,16,16,0,0,18,0,0,18,18,3.004363472
43220,47.3541257,-123.1738498,38860,43.6514172,-70.4183755,private,0,0,0,0,0,0,0,0,0,18,0,0,18,18,3.004363472
35620,40.77493,-73.873758,17980,32.4193768,-84.8437095,private,0,0,17,0,0,17,17,0,0,13,0,0,13,13,3.001246706
37980,39.8949576,-75.3119824,42380,41.7915044,-76.5021231,private,0,0,17,0,0,17,17,0,0,16,0,0,16,16,3.003116765
47900,38.7982054,-77.4868816,43900,34.9332708,-81.9910522,private,0,0,17,0,0,17,17,0,0,14,0,0,14,14,3.001870059
12060,33.693728,-84.3999113,37940,40.7728833,-86.0442575,private,0,0,17,0,0,17,17,0,0,15,0,0,15,15,3.002493412
33100,26.1018281,-80.4787552,18500,42.2667252,-77.3855253,private,0,0,17,0,0,17,17,0,0,13,0,0,13,13,3.001246706
33460,45.096664,-93.275361,47260,36.8044077,-76.4495261,private,0,0,29,0,0,29,29,0,0,52,0,0,52,52,3.025557476
33460,45.096664,-93.275361,16820,37.9490837,-78.5932062,private,0,0,17,0,0,17,17,0,0,12,0,0,12,12,3.000623353
16980,41.8235214,-87.8282967,30620,40.7716274,-84.1061032,private,0,0,17,0,0,17,17,0,0,14,0,0,14,14,3.001870059
19100,32.8491708,-96.9704894,39100,41.5752737,-74.0338729,private,0,0,17,0,0,17,17,0,0,11,0,0,11,11,3
19100,32.8491708,-96.9704894,16300,42.0863293,-91.6311439,private,0,0,32,0,0,32,32,0,0,13,0,0,13,13,3.001246706
26420,29.7495926,-95.3536422,43620,43.4954205,-96.9953387,private,0,0,17,0,0,17,17,0,0,12,0,0,12,12,3.000623353
20900,29.2784805,-96.2296745,37980,39.8949576,-75.3119824,private,0,0,58,0,0,58,58,0,0,14,0,0,14,14,3.001870059
26420,29.7495926,-95.3536422,48180,31.1331137,-82.3686504,private,0,0,17,0,0,17,17,0,0,22,0,0,22,22,3.006856884
26420,29.7495926,-95.3536422,42460,34.764114,-85.9800556,private,0,0,29,0,0,29,29,0,0,12,0,0,12,12,3.000623353
38060,33.1857653,-112.0678624,16820,37.9490837,-78.5932062,private,0,0,30,0,0,30,30,0,0,11,0,0,11,11,3
38060,33.1857653,-112.0678624,13820,33.4025986,-86.7295151,private,0,0,32,0,0,32,32,0,0,30,0,0,30,30,3.011843708
38060,33.1857653,-112.0678624,26340,47.6819737,-88.1487965,private,0,17,0,0,17,0,17,0,15,0,0,15,0,15,3.002493412
49740,32.7739424,-113.910905,30020,34.5291104,-98.4309172,private,0,0,17,0,0,17,17,0,0,16,0,0,16,16,3.003116765
42660,47.4905993,-121.833996,40340,43.9496362,-92.3360701,private,0,0,32,0,0,32,32,0,0,24,0,0,24,24,3.00810359
42660,47.4905993,-121.833996,29660,41.6655141,-105.7218826,private,0,0,17,0,0,17,17,0,0,28,0,0,28,28,3.010597002
34580,48.4932917,-121.8157703,17140,39.0998213,-84.4804072,private,0,0,17,0,0,17,17,0,0,24,0,0,24,24,3.00810359
14460,42.517606,-71.0219925,31660,44.5943758,-74.31067,private,0,0,0,0,0,0,0,0,0,17,0,0,17,17,3.003740118
14460,42.517606,-71.0219925,46540,43.3322796,-75.1731893,private,0,0,16,0,0,16,16,0,0,46,0,0,46,46,3.021817358
14460,42.517606,-71.0219925,25980,31.7787881,-81.5764801,private,0,0,0,0,0,0,0,0,0,17,0,0,17,17,3.003740118
14460,42.517606,-71.0219925,29200,40.4821533,-87.0171117,private,0,0,0,0,0,0,0,0,0,17,0,0,17,17,3.003740118
35620,40.77493,-73.873758,33940,38.3425479,-108.1622366,private,0,0,0,0,0,0,0,0,0,32,0,0,32,32,3.013090415
35620,40.77493,-73.873758,23060,41.1131166,-85.2177047,private,0,0,13,0,0,13,13,0,0,30,0,0,30,30,3.011843708
35620,40.77493,-73.873758,30700,40.8174581,-96.8687434,private,0,0,13,0,0,13,13,0,0,31,0,0,31,31,3.012467061
35620,40.77493,-73.873758,17780,30.7543917,-96.4885368,private,0,0,13,0,0,13,13,0,0,29,0,0,29,29,3.011220355
37980,39.8949576,-75.3119824,30100,43.7857256,-72.1591415,private,0,0,0,0,0,0,0,0,0,32,0,0,32,32,3.013090415
37980,39.8949576,-75.3119824,34060,39.5251551,-79.8019121,private,0,0,11,0,0,11,11,0,0,17,0,0,17,17,3.003740118
47900,38.7982054,-77.4868816,48180,31.1331137,-82.3686504,private,0,0,0,0,0,0,0,0,0,17,0,0,17,17,3.003740118
12060,33.693728,-84.3999113,49340,42.2173112,-71.9255354,private,0,0,0,0,0,0,0,0,0,29,0,0,29,29,3.011220355
12060,33.693728,-84.3999113,35980,41.4726517,-72.1086339,private,0,0,11,0,0,11,11,0,0,17,0,0,17,17,3.003740118
12060,33.693728,-84.3999113,17380,33.7991391,-90.8841199,private,0,0,25,0,0,25,25,0,0,17,0,0,17,17,3.003740118
12060,33.693728,-84.3999113,35940,41.1450798,-82.594641,private,0,0,13,0,0,13,13,0,0,17,0,0,17,17,3.003740118
12060,33.693728,-84.3999113,39900,40.5007953,-119.7311608,private,0,0,25,0,0,25,25,0,0,17,0,0,17,17,3.003740118
12060,33.693728,-84.3999113,14500,40.0949699,-105.3976911,private,0,0,26,0,0,26,26,0,0,31,0,0,31,31,3.012467061
33100,26.1018281,-80.4787552,40860,43.5808577,-73.0382023,private,0,14,0,0,14,0,14,0,17,0,0,17,0,17,3.003740118
33100,26.1018281,-80.4787552,49660,41.23646,-80.5617836,private,0,0,0,0,0,0,0,0,0,17,0,0,17,17,3.003740118
33100,26.1018281,-80.4787552,18100,41.5768655,-97.5134673,private,0,0,13,0,0,13,13,0,0,32,0,0,32,32,3.013090415
33100,26.1018281,-80.4787552,19700,32.1845231,-107.7471911,private,0,0,0,0,0,0,0,0,0,17,0,0,17,17,3.003740118
33100,26.1018281,-80.4787552,41500,36.240107,-121.3155723,private,0,0,0,0,0,0,0,0,0,28,0,0,28,28,3.010597002
33100,26.1018281,-80.4787552,10140,47.1137324,-123.8267349,private,0,0,12,0,0,12,12,0,0,30,0,0,30,30,3.011843708
33460,45.096664,-93.275361,39100,41.5752737,-74.0338729,private,0,0,0,0,0,0,0,0,0,17,0,0,17,17,3.003740118
33460,45.096664,-93.275361,22180,35.1559863,-78.93185,private,0,0,11,0,0,11,11,0,0,33,0,0,33,33,3.013713768
33460,45.096664,-93.275361,42340,32.1091533,-81.2731066,private,0,0,11,0,0,11,11,0,0,17,0,0,17,17,3.003740118
33460,45.096664,-93.275361,10100,45.5194353,-98.7007003,private,0,0,12,0,0,12,12,0,0,29,0,0,29,29,3.011220355
33460,45.096664,-93.275361,40420,42.331183,-89.0429139,private,0,0,15,0,0,15,15,0,0,32,0,0,32,32,3.013090415
33460,45.096664,-93.275361,17660,47.6759658,-116.6959222,private,0,0,28,0,0,28,28,0,0,29,0,0,29,29,3.011220355
33460,45.096664,-93.275361,42020,35.3852242,-120.4475445,private,0,0,25,0,0,25,25,0,0,17,0,0,17,17,3.003740118
33460,45.096664,-93.275361,32780,42.4116214,-122.6756106,private,0,0,0,0,0,0,0,0,0,17,0,0,17,17,3.003740118
16980,41.8235214,-87.8282967,42460,34.764114,-85.9800556,private,0,0,12,0,0,12,12,0,0,46,0,0,46,46,3.021817358
16980,41.8235214,-87.8282967,30100,43.7857256,-72.1591415,private,0,0,15,0,0,15,15,0,0,32,0,0,32,32,3.013090415
16980,41.8235214,-87.8282967,29540,40.0419921,-76.250198,private,0,0,0,0,0,0,0,0,0,31,0,0,31,31,3.012467061
19100,32.8491708,-96.9704894,10420,41.1466395,-81.3501104,private,13,0,0,0,0,13,13,0,0,17,0,0,17,17,3.003740118
19100,32.8491708,-96.9704894,33540,47.0272632,-113.8926911,private,0,0,11,0,0,11,11,0,0,17,0,0,17,17,3.003740118
19100,32.8491708,-96.9704894,37900,40.7088872,-89.6974658,private,0,0,12,0,0,12,12,0,0,28,0,0,28,28,3.010597002
19100,32.8491708,-96.9704894,37500,36.1206072,-90.5663459,private,0,0,16,0,0,16,16,0,0,28,0,0,28,28,3.010597002
19100,32.8491708,-96.9704894,29660,41.6655141,-105.7218826,private,0,0,0,0,0,0,0,0,0,17,0,0,17,17,3.003740118
26420,29.7495926,-95.3536422,12260,33.4603713,-81.9828327,private,0,0,12,0,0,12,12,0,0,40,0,0,40,40,3.018077239
26420,29.7495926,-95.3536422,12020,33.943984,-83.2138965,private,0,0,14,0,0,14,14,0,0,17,0,0,17,17,3.003740118
26420,29.7495926,-95.3536422,45780,41.5553128,-83.5170883,private,0,0,12,0,0,12,12,0,0,17,0,0,17,17,3.003740118
26420,29.7495926,-95.3536422,23780,38.0254528,-100.9706954,private,0,0,0,0,0,0,0,0,0,17,0,0,17,17,3.003740118
26420,29.7495926,-95.3536422,24540,40.555961,-104.383666,private,0,0,0,0,0,0,0,0,0,33,0,0,33,33,3.013713768
20900,29.2784805,-96.2296745,17460,41.7603919,-81.7242168,private,0,0,14,0,0,14,14,0,0,17,0,0,17,17,3.003740118
38060,33.1857653,-112.0678624,25060,30.4801526,-88.9992972,private,0,0,16,0,0,16,16,0,0,45,0,0,45,45,3.021194004
38060,33.1857653,-112.0678624,22420,43.0210768,-83.7063718,private,0,0,0,0,0,0,0,0,0,32,0,0,32,32,3.013090415
38060,33.1857653,-112.0678624,16060,37.6897419,-89.1051489,private,0,0,12,0,0,12,12,0,0,30,0,0,30,30,3.011843708
38060,33.1857653,-112.0678624,31180,33.4703271,-101.6488249,private,0,0,11,0,0,11,11,0,0,29,0,0,29,29,3.011220355
49740,32.7739424,-113.910905,36380,27.3855924,-80.8873884,private,0,0,12,0,0,12,12,0,0,17,0,0,17,17,3.003740118
49740,32.7739424,-113.910905,30780,34.7557726,-92.4005889,private,0,0,25,0,0,25,25,0,0,28,0,0,28,28,3.010597002
49740,32.7739424,-113.910905,16180,39.1530598,-119.7473681,private,0,0,0,0,0,0,0,0,17,0,0,17,0,17,3.003740118
31080,34.1087033,-118.1827533,41540,38.3995211,-75.4782615,private,0,0,13,0,0,13,13,0,0,17,0,0,17,17,3.003740118
31080,34.1087033,-118.1827533,35900,36.2088833,-81.1660949,private,0,0,13,0,0,13,13,0,0,29,0,0,29,29,3.011220355
41860,37.7737185,-122.2744317,46140,36.2544287,-96.1773294,private,0,0,0,0,0,0,0,0,0,30,0,0,30,30,3.011843708
42660,47.4905993,-121.833996,26620,34.7832617,-86.7348706,private,0,0,0,0,0,0,0,0,0,29,0,0,29,29,3.011220355
42660,47.4905993,-121.833996,19700,32.1845231,-107.7471911,private,0,0,27,0,0,27,27,0,0,17,0,0,17,17,3.003740118
42660,47.4905993,-121.833996,35900,36.2088833,-81.1660949,private,0,0,12,0,0,12,12,0,0,29,0,0,29,29,3.011220355
42660,47.4905993,-121.833996,16300,42.0863293,-91.6311439,private,0,0,0,0,0,0,0,0,0,17,0,0,17,17,3.003740118
42660,47.4905993,-121.833996,45000,40.7210862,-120.6299518,private,0,0,14,0,0,14,14,0,0,17,0,0,17,17,3.003740118
34580,48.4932917,-121.8157703,41500,36.240107,-121.3155723,private,0,0,15,0,0,15,15,0,0,17,0,0,17,17,3.003740118
43220,47.3541257,-123.1738498,21700,40.7066554,-123.9261757,private,0,0,0,0,0,0,0,0,0,17,0,0,17,17,3.003740118
14460,42.517606,-71.0219925,10140,47.1137324,-123.8267349,private,0,0,16,0,0,16,16,0,0,11,0,0,11,11,3
35620,40.77493,-73.873758,32780,42.4116214,-122.6756106,private,0,0,16,0,0,16,16,0,0,15,0,0,15,15,3.002493412
35620,40.77493,-73.873758,21300,42.1552804,-76.7471791,private,0,0,16,0,0,16,16,0,0,15,0,0,15,15,3.002493412
12060,33.693728,-84.3999113,49020,39.2729744,-78.4718276,private,0,0,16,0,0,16,16,0,0,12,0,0,12,12,3.000623353
12060,33.693728,-84.3999113,30620,40.7716274,-84.1061032,private,0,0,16,0,0,16,16,0,0,15,0,0,15,15,3.002493412
33100,26.1018281,-80.4787552,42460,34.764114,-85.9800556,private,0,0,28,0,0,28,28,12,0,0,0,0,12,12,3.000623353
33100,26.1018281,-80.4787552,29980,35.2204764,-87.396546,private,0,0,16,0,0,16,16,0,0,13,0,0,13,13,3.001246706
33100,26.1018281,-80.4787552,38500,41.3250032,-86.2690363,private,0,0,29,0,0,29,29,0,0,12,0,0,12,12,3.000623353
33460,45.096664,-93.275361,11700,35.5956693,-82.6816145,private,0,0,32,0,0,32,32,0,0,54,0,0,54,54,3.026804182
16980,41.8235214,-87.8282967,12220,32.6040644,-85.3530477,private,0,0,16,0,0,16,16,0,0,12,0,0,12,12,3.000623353
16980,41.8235214,-87.8282967,22380,35.8296919,-111.7737277,private,0,0,16,0,0,16,16,0,0,12,0,0,12,12,3.000623353
16980,41.8235214,-87.8282967,32780,42.4116214,-122.6756106,private,0,0,16,0,0,16,16,0,0,25,0,0,25,25,3.008726943
19100,32.8491708,-96.9704894,40340,43.9496362,-92.3360701,private,0,0,16,0,0,16,16,0,0,13,0,0,13,13,3.001246706
19100,32.8491708,-96.9704894,29780,35.6440668,-104.8630266,private,0,16,0,0,16,0,16,0,12,0,0,12,0,12,3.000623353
26420,29.7495926,-95.3536422,16860,35.0493612,-85.3611582,private,0,0,29,0,0,29,29,0,0,35,0,0,35,35,3.014960474
38060,33.1857653,-112.0678624,12940,30.5187808,-91.1255901,private,0,0,45,0,0,45,45,0,0,11,0,0,11,11,3
49740,32.7739424,-113.910905,17900,34.0775845,-81.0378453,private,11,0,27,0,0,38,38,0,0,11,0,0,11,11,3
49740,32.7739424,-113.910905,15140,35.5866782,-89.2826913,private,0,0,16,0,0,16,16,0,0,14,0,0,14,14,3.001870059
49740,32.7739424,-113.910905,21220,40.9060857,-115.5545775,private,0,16,0,0,16,0,16,0,15,0,0,15,0,15,3.002493412
31080,34.1087033,-118.1827533,12100,39.4693555,-74.6337591,private,0,0,16,0,0,16,16,0,0,15,0,0,15,15,3.002493412
31080,34.1087033,-118.1827533,29540,40.0419921,-76.250198,private,0,0,16,0,0,16,16,0,0,14,0,0,14,14,3.001870059
31080,34.1087033,-118.1827533,31180,33.4703271,-101.6488249,private,0,0,16,0,0,16,16,0,0,11,0,0,11,11,3
42660,47.4905993,-121.833996,14020,39.2417362,-86.6717544,private,0,0,16,0,0,16,16,0,0,15,0,0,15,15,3.002493412
43220,47.3541257,-123.1738498,40060,37.4113241,-77.4418164,private,0,0,31,0,0,31,31,0,0,16,0,0,16,16,3.003116765
42660,47.4905993,-121.833996,25060,30.4801526,-88.9992972,private,0,0,43,0,0,43,43,0,0,16,0,0,16,16,3.003116765
14460,42.517606,-71.0219925,29540,40.0419921,-76.250198,private,0,0,13,0,0,13,13,0,0,27,0,0,27,27,3.009973649
14460,42.517606,-71.0219925,44980,40.8515244,-76.709877,private,0,0,14,0,0,14,14,0,0,16,0,0,16,16,3.003116765
14460,42.517606,-71.0219925,28660,31.2027301,-97.7896384,private,0,0,14,0,0,14,14,0,0,16,0,0,16,16,3.003116765
35620,40.77493,-73.873758,25180,39.5544327,-77.9845935,private,0,0,0,0,0,0,0,0,0,16,0,0,16,16,3.003116765
35620,40.77493,-73.873758,27740,36.2658223,-82.3326926,private,0,0,0,0,0,0,0,0,0,31,0,0,31,31,3.012467061
35620,40.77493,-73.873758,29180,29.9577733,-92.0493498,private,0,0,0,0,0,0,0,0,0,30,0,0,30,30,3.011843708
35620,40.77493,-73.873758,19700,32.1845231,-107.7471911,private,0,0,0,0,0,0,0,0,0,16,0,0,16,16,3.003116765
37980,39.8949576,-75.3119824,35980,41.4726517,-72.1086339,private,0,0,27,0,0,27,27,0,0,16,0,0,16,16,3.003116765
37980,39.8949576,-75.3119824,36300,44.4881125,-75.074311,private,0,0,0,0,0,0,0,0,0,16,0,0,16,16,3.003116765
37980,39.8949576,-75.3119824,22020,46.9148591,-96.9601826,private,0,0,15,0,0,15,15,0,0,16,0,0,16,16,3.003116765
37980,39.8949576,-75.3119824,31700,42.9115317,-71.7230554,private,0,0,28,0,0,28,28,0,0,30,0,0,30,30,3.011843708
37980,39.8949576,-75.3119824,12540,35.3466288,-118.7295064,private,0,0,0,0,0,0,0,0,0,27,0,0,27,27,3.009973649
37980,39.8949576,-75.3119824,10540,44.4888982,-122.5372084,private,0,0,0,0,0,0,0,0,0,16,0,0,16,16,3.003116765
47900,38.7982054,-77.4868816,44980,40.8515244,-76.709877,private,0,0,0,0,0,0,0,0,0,16,0,0,16,16,3.003116765
47900,38.7982054,-77.4868816,12940,30.5187808,-91.1255901,private,0,0,14,0,0,14,14,0,0,16,0,0,16,16,3.003116765
47900,38.7982054,-77.4868816,33700,37.5623162,-121.0028311,private,0,0,11,0,0,11,11,0,0,16,0,0,16,16,3.003116765
12060,33.693728,-84.3999113,12100,39.4693555,-74.6337591,private,0,0,0,0,0,0,0,0,0,16,0,0,16,16,3.003116765
33100,26.1018281,-80.4787552,33700,37.5623162,-121.0028311,private,0,0,26,0,0,26,26,0,0,31,0,0,31,31,3.012467061
33100,26.1018281,-80.4787552,29180,29.9577733,-92.0493498,private,0,0,12,0,0,12,12,0,0,28,0,0,28,28,3.010597002
33100,26.1018281,-80.4787552,30780,34.7557726,-92.4005889,private,0,0,11,0,0,11,11,0,0,55,0,0,55,55,3.027427535
33460,45.096664,-93.275361,29620,42.7712334,-84.4960294,private,0,0,24,0,0,24,24,0,0,16,0,0,16,16,3.003116765
33460,45.096664,-93.275361,33500,48.3202424,-101.1980099,private,0,0,0,0,0,0,0,0,0,31,0,0,31,31,3.012467061
33460,45.096664,-93.275361,14010,40.4945594,-88.8445391,private,0,0,12,0,0,12,12,0,0,16,0,0,16,16,3.003116765
33460,45.096664,-93.275361,46380,39.4323876,-123.4428811,private,0,0,14,0,0,14,14,0,0,16,0,0,16,16,3.003116765
16980,41.8235214,-87.8282967,49340,42.2173112,-71.9255354,private,0,0,37,0,0,37,37,0,0,28,0,0,28,28,3.010597002
16980,41.8235214,-87.8282967,31700,42.9115317,-71.7230554,private,0,0,26,0,0,26,26,0,0,38,0,0,38,38,3.016830533
16980,41.8235214,-87.8282967,29060,43.5191091,-71.4253661,private,0,0,0,0,0,0,0,0,0,16,0,0,16,16,3.003116765
16980,41.8235214,-87.8282967,20260,47.3475056,-92.1553326,private,0,0,12,0,0,12,12,0,0,16,0,0,16,16,3.003116765
16980,41.8235214,-87.8282967,31740,39.2684241,-96.5622422,private,0,0,12,0,0,12,12,0,0,28,0,0,28,28,3.010597002
16980,41.8235214,-87.8282967,24300,39.019524,-108.4605707,private,0,0,0,0,0,0,0,0,0,16,0,0,16,16,3.003116765
19100,32.8491708,-96.9704894,43900,34.9332708,-81.9910522,private,0,0,13,0,0,13,13,0,0,16,0,0,16,16,3.003116765
19100,32.8491708,-96.9704894,46220,33.0978758,-87.7991533,private,0,0,0,0,0,0,0,0,0,16,0,0,16,16,3.003116765
19100,32.8491708,-96.9704894,17020,39.6659588,-121.6019188,private,0,0,0,0,0,0,0,0,0,40,0,0,40,40,3.018077239
26420,29.7495926,-95.3536422,38500,41.3250032,-86.2690363,private,0,0,12,0,0,12,12,0,0,16,0,0,16,16,3.003116765
20900,29.2784805,-96.2296745,39300,41.7068313,-71.2866369,private,0,0,0,0,0,0,0,0,0,16,0,0,16,16,3.003116765
20900,29.2784805,-96.2296745,47260,36.8044077,-76.4495261,private,11,0,0,0,0,11,11,0,0,16,0,0,16,16,3.003116765
20900,29.2784805,-96.2296745,18140,39.9685617,-82.8359105,private,0,0,12,0,0,12,12,0,0,30,0,0,30,30,3.011843708
20900,29.2784805,-96.2296745,19820,42.7218478,-83.2008463,private,0,0,27,0,0,27,27,0,0,44,0,0,44,44,3.020570651
20900,29.2784805,-96.2296745,48620,37.637896,-97.2462875,private,0,0,15,0,0,15,15,0,0,16,0,0,16,16,3.003116765
38060,33.1857653,-112.0678624,25980,31.7787881,-81.5764801,private,0,0,13,0,0,13,13,0,0,31,0,0,31,31,3.012467061
38060,33.1857653,-112.0678624,45820,39.0413888,-95.8026393,private,0,0,0,0,0,0,0,0,0,32,0,0,32,32,3.013090415
38060,33.1857653,-112.0678624,12100,39.4693555,-74.6337591,private,0,0,0,0,0,0,0,0,0,16,0,0,16,16,3.003116765
38060,33.1857653,-112.0678624,20500,36.0605886,-78.9897875,private,0,0,15,0,0,15,15,0,0,30,0,0,30,30,3.011843708
38060,33.1857653,-112.0678624,12260,33.4603713,-81.9828327,private,0,0,0,0,0,0,0,0,0,16,0,0,16,16,3.003116765
38060,33.1857653,-112.0678624,17780,30.7543917,-96.4885368,private,0,0,13,0,0,13,13,0,0,16,0,0,16,16,3.003116765
31080,34.1087033,-118.1827533,15540,44.6891168,-73.0411707,private,0,0,15,0,0,15,15,0,0,16,0,0,16,16,3.003116765
31080,34.1087033,-118.1827533,49660,41.23646,-80.5617836,private,0,0,0,0,0,0,0,0,0,16,0,0,16,16,3.003116765
31080,34.1087033,-118.1827533,40300,42.041884,-89.3201764,private,0,0,0,0,0,0,0,0,0,16,0,0,16,16,3.003116765
41860,37.7737185,-122.2744317,25420,40.335915,-77.0504897,private,0,0,0,0,0,0,0,0,0,16,0,0,16,16,3.003116765
41860,37.7737185,-122.2744317,47260,36.8044077,-76.4495261,private,0,0,0,0,0,0,0,0,0,27,0,0,27,27,3.009973649
41860,37.7737185,-122.2744317,34740,43.2892579,-86.751892,private,0,0,0,0,0,0,0,0,0,16,0,0,16,16,3.003116765
41860,37.7737185,-122.2744317,24340,43.0375977,-85.7781669,private,0,0,13,0,0,13,13,0,0,16,0,0,16,16,3.003116765
41860,37.7737185,-122.2744317,19780,41.5770501,-93.7597124,private,0,0,0,0,0,0,0,0,0,16,0,0,16,16,3.003116765
41860,37.7737185,-122.2744317,29940,38.8964168,-95.2909475,private,0,0,0,0,0,0,0,0,0,16,0,0,16,16,3.003116765
42660,47.4905993,-121.833996,46340,32.3770156,-95.2700409,private,0,0,12,0,0,12,12,0,0,16,0,0,16,16,3.003116765
42660,47.4905993,-121.833996,16860,35.0493612,-85.3611582,private,0,0,12,0,0,12,12,0,0,41,0,0,41,41,3.018700592
42660,47.4905993,-121.833996,43620,43.4954205,-96.9953387,private,0,0,15,0,0,15,15,0,0,16,0,0,16,16,3.003116765
42660,47.4905993,-121.833996,27220,44.048662,-110.426087,private,0,0,0,0,0,0,0,0,0,16,0,0,16,16,3.003116765
34580,48.4932917,-121.8157703,31460,37.2098213,-119.7498023,private,0,0,13,0,0,13,13,0,0,16,0,0,16,16,3.003116765
43220,47.3541257,-123.1738498,48900,34.4260331,-77.889634,private,11,0,0,0,0,11,11,0,0,16,0,0,16,16,3.003116765
43220,47.3541257,-123.1738498,36100,29.2028047,-82.0431004,private,0,0,11,0,0,11,11,0,0,16,0,0,16,16,3.003116765
43220,47.3541257,-123.1738498,10460,32.6155988,-105.7513079,private,0,0,0,0,0,0,0,0,0,16,0,0,16,16,3.003116765
14460,42.517606,-71.0219925,46140,36.2544287,-96.1773294,private,0,0,15,0,0,15,15,0,0,15,0,0,15,15,3.002493412
37980,39.8949576,-75.3119824,12260,33.4603713,-81.9828327,private,0,0,15,0,0,15,15,0,0,23,0,0,23,23,3.007480237
37980,39.8949576,-75.3119824,14020,39.2417362,-86.6717544,private,0,0,15,0,0,15,15,0,0,11,0,0,11,11,3
37980,39.8949576,-75.3119824,12940,30.5187808,-91.1255901,private,0,0,15,0,0,15,15,0,0,12,0,0,12,12,3.000623353
47900,38.7982054,-77.4868816,19780,41.5770501,-93.7597124,private,0,0,15,0,0,15,15,0,0,14,0,0,14,14,3.001870059
47900,38.7982054,-77.4868816,22220,36.1163935,-94.0795449,private,0,0,15,0,0,15,15,0,0,11,0,0,11,11,3
12060,33.693728,-84.3999113,38860,43.6514172,-70.4183755,private,0,0,28,0,0,28,28,0,0,13,0,0,13,13,3.001246706
12060,33.693728,-84.3999113,44180,37.3608699,-93.1802617,private,0,0,38,0,0,38,38,11,0,14,0,0,25,25,3.008726943
33100,26.1018281,-80.4787552,29940,38.8964168,-95.2909475,private,0,0,15,0,0,15,15,0,0,24,0,0,24,24,3.00810359
33100,26.1018281,-80.4787552,48620,37.637896,-97.2462875,private,0,0,15,0,0,15,15,0,0,23,0,0,23,23,3.007480237
33100,26.1018281,-80.4787552,18580,27.8335972,-97.5089575,private,0,0,15,0,0,15,15,0,0,13,0,0,13,13,3.001246706
16980,41.8235214,-87.8282967,24540,40.555961,-104.383666,private,0,0,39,0,0,39,39,0,0,26,0,0,26,26,3.009350296
19100,32.8491708,-96.9704894,16820,37.9490837,-78.5932062,private,0,0,15,0,0,15,15,0,0,12,0,0,12,12,3.000623353
26420,29.7495926,-95.3536422,19460,34.4893614,-87.0971469,private,0,0,27,0,0,27,27,0,0,13,0,0,13,13,3.001246706
26420,29.7495926,-95.3536422,10420,41.1466395,-81.3501104,private,0,0,15,0,0,15,15,0,0,28,0,0,28,28,3.010597002
20900,29.2784805,-96.2296745,29460,27.9536488,-81.6935337,private,0,0,15,0,0,15,15,0,0,15,0,0,15,15,3.002493412
38060,33.1857653,-112.0678624,23940,44.2321004,-105.0343417,private,0,15,0,0,15,0,15,0,25,0,0,25,0,25,3.008726943
49740,32.7739424,-113.910905,14500,40.0949699,-105.3976911,private,0,15,0,0,15,0,15,0,12,0,0,12,0,12,3.000623353
31080,34.1087033,-118.1827533,22380,35.8296919,-111.7737277,private,0,0,66,0,0,66,66,0,0,54,0,0,54,54,3.026804182
42660,47.4905993,-121.833996,15620,44.3287385,-85.3264287,private,0,0,26,0,0,26,26,0,0,11,0,0,11,11,3
34580,48.4932917,-121.8157703,17460,41.7603919,-81.7242168,private,0,0,28,0,0,28,28,0,0,25,0,0,25,25,3.008726943
43220,47.3541257,-123.1738498,37980,39.8949576,-75.3119824,private,0,0,27,0,0,27,27,0,0,11,0,0,11,11,3
14460,42.517606,-71.0219925,27740,36.2658223,-82.3326926,private,0,0,0,0,0,0,0,0,0,15,0,0,15,15,3.002493412
14460,42.517606,-71.0219925,30700,40.8174581,-96.8687434,private,0,0,0,0,0,0,0,0,0,15,0,0,15,15,3.002493412
35620,40.77493,-73.873758,18180,43.2995786,-71.6800412,private,0,0,0,0,0,0,0,0,0,15,0,0,15,15,3.002493412
35620,40.77493,-73.873758,42460,34.764114,-85.9800556,private,0,0,0,0,0,0,0,0,0,15,0,0,15,15,3.002493412
35620,40.77493,-73.873758,28060,48.3146779,-114.0542951,private,0,0,0,0,0,0,0,0,0,26,0,0,26,26,3.009350296
35620,40.77493,-73.873758,23340,41.5770082,-96.6458526,private,0,0,0,0,0,0,0,0,0,15,0,0,15,15,3.002493412
35620,40.77493,-73.873758,12540,35.3466288,-118.7295064,private,0,0,14,0,0,14,14,0,0,29,0,0,29,29,3.011220355
35620,40.77493,-73.873758,34060,39.5251551,-79.8019121,private,0,0,0,0,0,0,0,0,0,26,0,0,26,26,3.009350296
35620,40.77493,-73.873758,45780,41.5553128,-83.5170883,private,0,0,0,0,0,0,0,0,0,27,0,0,27,27,3.009973649
37980,39.8949576,-75.3119824,21020,36.1968134,-76.3426012,private,0,0,0,0,0,0,0,0,0,15,0,0,15,15,3.002493412
37980,39.8949576,-75.3119824,35900,36.2088833,-81.1660949,private,0,0,0,0,0,0,0,0,0,29,0,0,29,29,3.011220355
37980,39.8949576,-75.3119824,29620,42.7712334,-84.4960294,private,0,0,0,0,0,0,0,0,0,15,0,0,15,15,3.002493412
37980,39.8949576,-75.3119824,16580,40.1029885,-88.3185039,private,0,0,0,0,0,0,0,0,0,15,0,0,15,15,3.002493412
37980,39.8949576,-75.3119824,46380,39.4323876,-123.4428811,private,0,0,0,0,0,0,0,0,0,15,0,0,15,15,3.002493412
47900,38.7982054,-77.4868816,38340,42.371493,-73.2179276,private,0,0,0,0,0,0,0,0,0,15,0,0,15,15,3.002493412
47900,38.7982054,-77.4868816,12620,45.4092843,-68.666616,private,0,0,0,0,0,0,0,0,0,15,0,0,15,15,3.002493412
47900,38.7982054,-77.4868816,12740,44.2749884,-72.6095138,private,0,0,11,0,0,11,11,0,0,15,0,0,15,15,3.002493412
47900,38.7982054,-77.4868816,29460,27.9536488,-81.6935337,private,0,0,0,0,0,0,0,0,0,15,0,0,15,15,3.002493412
47900,38.7982054,-77.4868816,15140,35.5866782,-89.2826913,private,0,0,0,0,0,0,0,0,0,15,0,0,15,15,3.002493412
47900,38.7982054,-77.4868816,33540,47.0272632,-113.8926911,private,0,0,0,0,0,0,0,0,0,15,0,0,15,15,3.002493412
47900,38.7982054,-77.4868816,40700,43.2863277,-123.154476,private,0,0,12,0,0,12,12,0,0,15,0,0,15,15,3.002493412
12060,33.693728,-84.3999113,21020,36.1968134,-76.3426012,private,0,0,0,0,0,0,0,0,0,15,0,0,15,15,3.002493412
12060,33.693728,-84.3999113,17860,38.9864864,-92.5851888,private,0,0,13,0,0,13,13,0,0,15,0,0,15,15,3.002493412
12060,33.693728,-84.3999113,29340,29.9787547,-93.2532434,private,0,0,13,0,0,13,13,0,0,15,0,0,15,15,3.002493412
12060,33.693728,-84.3999113,22620,35.0228383,-90.7515053,private,0,0,0,0,0,0,0,0,0,15,0,0,15,15,3.002493412
12060,33.693728,-84.3999113,24980,33.770031,-89.8027405,private,0,0,13,0,0,13,13,0,0,27,0,0,27,27,3.009973649
12060,33.693728,-84.3999113,42200,34.5370572,-120.0399729,private,0,0,13,0,0,13,13,0,0,15,0,0,15,15,3.002493412
12060,33.693728,-84.3999113,23420,36.7610058,-119.6550193,private,0,0,14,0,0,14,14,0,0,15,0,0,15,15,3.002493412
33100,26.1018281,-80.4787552,12620,45.4092843,-68.666616,private,0,0,0,0,0,0,0,0,0,15,0,0,15,15,3.002493412
33100,26.1018281,-80.4787552,21060,37.7329803,-85.9721707,private,0,0,24,0,0,24,24,0,0,15,0,0,15,15,3.002493412
33100,26.1018281,-80.4787552,44060,48.091618,-117.663472,private,0,0,0,0,0,0,0,0,0,15,0,0,15,15,3.002493412
33460,45.096664,-93.275361,44140,42.3648332,-72.6194063,private,0,0,13,0,0,13,13,0,0,15,0,0,15,15,3.002493412
33460,45.096664,-93.275361,15540,44.6891168,-73.0411707,private,0,0,13,0,0,13,13,0,0,15,0,0,15,15,3.002493412
33460,45.096664,-93.275361,48900,34.4260331,-77.889634,private,0,0,11,0,0,11,11,0,0,15,0,0,15,15,3.002493412
33460,45.096664,-93.275361,25940,32.3867916,-80.8308775,private,0,14,0,0,14,0,14,0,27,0,0,27,0,27,3.009973649
16980,41.8235214,-87.8282967,31340,37.3649258,-79.2166894,private,0,0,0,0,0,0,0,0,0,28,0,0,28,28,3.010597002
16980,41.8235214,-87.8282967,35860,38.9962289,-85.628103,private,0,0,0,0,0,0,0,0,0,15,0,0,15,15,3.002493412
16980,41.8235214,-87.8282967,29180,29.9577733,-92.0493498,private,0,0,0,0,0,0,0,0,0,15,0,0,15,15,3.002493412
16980,41.8235214,-87.8282967,17780,30.7543917,-96.4885368,private,0,0,11,0,0,11,11,0,0,15,0,0,15,15,3.002493412
16980,41.8235214,-87.8282967,28420,46.3639636,-119.2540459,private,0,0,12,0,0,12,12,0,0,15,0,0,15,15,3.002493412
19100,32.8491708,-96.9704894,41540,38.3995211,-75.4782615,private,0,0,0,0,0,0,0,0,0,15,0,0,15,15,3.002493412
19100,32.8491708,-96.9704894,12260,33.4603713,-81.9828327,private,0,0,0,0,0,0,0,0,0,29,0,0,29,29,3.011220355
19100,32.8491708,-96.9704894,17980,32.4193768,-84.8437095,private,0,0,0,0,0,0,0,0,0,15,0,0,15,15,3.002493412
19100,32.8491708,-96.9704894,38500,41.3250032,-86.2690363,private,0,0,12,0,0,12,12,0,0,15,0,0,15,15,3.002493412
19100,32.8491708,-96.9704894,23540,29.4807065,-82.6274667,private,0,0,27,0,0,27,27,0,0,29,0,0,29,29,3.011220355
26420,29.7495926,-95.3536422,15540,44.6891168,-73.0411707,private,0,0,0,0,0,0,0,0,0,15,0,0,15,15,3.002493412
26420,29.7495926,-95.3536422,14020,39.2417362,-86.6717544,private,0,0,0,0,0,0,0,0,0,15,0,0,15,15,3.002493412
26420,29.7495926,-95.3536422,16060,37.6897419,-89.1051489,private,0,0,0,0,0,0,0,0,0,15,0,0,15,15,3.002493412
26420,29.7495926,-95.3536422,27900,37.0555457,-94.3397364,private,0,0,0,0,0,0,0,0,0,15,0,0,15,15,3.002493412
26420,29.7495926,-95.3536422,39150,34.631071,-112.5772247,private,0,0,0,0,0,0,0,0,0,15,0,0,15,15,3.002493412
26420,29.7495926,-95.3536422,23420,36.7610058,-119.6550193,private,0,0,12,0,0,12,12,0,0,15,0,0,15,15,3.002493412
20900,29.2784805,-96.2296745,33340,43.0176601,-87.4815541,private,0,0,0,0,0,0,0,0,0,15,0,0,15,15,3.002493412
20900,29.2784805,-96.2296745,29940,38.8964168,-95.2909475,private,0,0,0,0,0,0,0,0,0,15,0,0,15,15,3.002493412
26420,29.7495926,-95.3536422,10380,18.3569648,-67.0078951,private,0,0,12,0,0,12,12,0,0,15,0,0,15,15,3.002493412
38060,33.1857653,-112.0678624,27140,32.4282801,-90.2023875,private,0,0,0,0,0,0,0,0,0,15,0,0,15,15,3.002493412
38060,33.1857653,-112.0678624,33660,30.9715095,-88.20787,private,0,0,0,0,0,0,0,0,0,15,0,0,15,15,3.002493412
38060,33.1857653,-112.0678624,27740,36.2658223,-82.3326926,private,0,0,11,0,0,11,11,0,0,38,0,0,38,38,3.016830533
49740,32.7739424,-113.910905,23540,29.4807065,-82.6274667,private,0,0,0,0,0,0,0,0,0,15,0,0,15,15,3.002493412
49740,32.7739424,-113.910905,14540,37.0468241,-86.3970408,private,0,0,12,0,0,12,12,0,0,15,0,0,15,15,3.002493412
31080,34.1087033,-118.1827533,15940,40.7110505,-81.261468,private,0,0,0,0,0,0,0,0,0,15,0,0,15,15,3.002493412
31080,34.1087033,-118.1827533,43620,43.4954205,-96.9953387,private,0,0,25,0,0,25,25,0,0,15,0,0,15,15,3.002493412
31080,34.1087033,-118.1827533,30980,32.4316457,-94.6848326,private,0,0,0,0,0,0,0,0,0,15,0,0,15,15,3.002493412
31080,34.1087033,-118.1827533,18580,27.8335972,-97.5089575,private,0,0,13,0,0,13,13,0,0,29,0,0,29,29,3.011220355
31080,34.1087033,-118.1827533,31740,39.2684241,-96.5622422,private,0,0,0,0,0,0,0,0,0,15,0,0,15,15,3.002493412
41860,37.7737185,-122.2744317,12740,44.2749884,-72.6095138,private,0,0,0,0,0,0,0,0,0,15,0,0,15,15,3.002493412
41860,37.7737185,-122.2744317,11220,42.9008912,-74.4353575,private,0,0,14,0,0,14,14,0,0,15,0,0,15,15,3.002493412
41860,37.7737185,-122.2744317,19430,39.8288538,-84.1418129,private,0,0,0,0,0,0,0,0,0,15,0,0,15,15,3.002493412
41860,37.7737185,-122.2744317,32580,26.3963839,-98.18099,private,0,0,0,0,0,0,0,0,0,15,0,0,15,15,3.002493412
41860,37.7737185,-122.2744317,22380,35.8296919,-111.7737277,private,0,0,0,0,0,0,0,0,0,15,0,0,15,15,3.002493412
41860,37.7737185,-122.2744317,16180,39.1530598,-119.7473681,private,0,0,0,0,0,0,0,0,0,26,0,0,26,26,3.009350296
42660,47.4905993,-121.833996,36380,27.3855924,-80.8873884,private,0,0,12,0,0,12,12,0,0,29,0,0,29,29,3.011220355
42660,47.4905993,-121.833996,36260,41.276061,-113.126226,private,0,0,12,0,0,12,12,0,0,64,0,0,64,64,3.033037713
42660,47.4905993,-121.833996,41980,18.2944526,-66.0368437,private,0,0,0,0,0,0,0,0,0,15,0,0,15,15,3.002493412
42660,47.4905993,-121.833996,15680,38.2202894,-76.5303837,private,0,0,0,0,0,0,0,0,0,29,0,0,29,29,3.011220355
42660,47.4905993,-121.833996,45780,41.5553128,-83.5170883,private,0,0,12,0,0,12,12,0,0,15,0,0,15,15,3.002493412
34580,48.4932917,-121.8157703,16740,35.1663423,-80.7972848,private,0,0,11,0,0,11,11,0,0,15,0,0,15,15,3.002493412
34580,48.4932917,-121.8157703,48620,37.637896,-97.2462875,private,13,0,0,0,0,13,13,0,0,29,0,0,29,29,3.011220355
34580,48.4932917,-121.8157703,30980,32.4316457,-94.6848326,private,0,0,0,0,0,0,0,15,0,0,0,0,15,15,3.002493412
43220,47.3541257,-123.1738498,24660,36.0252039,-79.7926333,private,0,0,0,0,0,0,0,0,0,15,0,0,15,15,3.002493412
43220,47.3541257,-123.1738498,16740,35.1663423,-80.7972848,private,0,0,0,0,0,0,0,0,0,15,0,0,15,15,3.002493412
43220,47.3541257,-123.1738498,19820,42.7218478,-83.2008463,private,0,0,13,0,0,13,13,0,0,15,0,0,15,15,3.002493412
14460,42.517606,-71.0219925,14260,43.0066485,-116.1419089,private,0,0,14,0,0,14,14,0,0,14,0,0,14,14,3.001870059
35620,40.77493,-73.873758,25500,38.5075848,-78.8853213,private,0,0,14,0,0,14,14,0,0,11,0,0,11,11,3
12060,33.693728,-84.3999113,36300,44.4881125,-75.074311,private,0,0,14,0,0,14,14,0,0,14,0,0,14,14,3.001870059
12060,33.693728,-84.3999113,39660,44.3154852,-102.7683833,private,0,0,14,0,0,14,14,0,0,11,0,0,11,11,3
33100,26.1018281,-80.4787552,33860,32.3656313,-86.4045848,private,0,0,27,0,0,27,27,0,0,23,0,0,23,23,3.007480237
33460,45.096664,-93.275361,44180,37.3608699,-93.1802617,private,0,0,14,0,0,14,14,0,0,12,0,0,12,12,3.000623353
33460,45.096664,-93.275361,39300,41.7068313,-71.2866369,private,0,0,27,0,0,27,27,0,0,24,0,0,24,24,3.00810359
33460,45.096664,-93.275361,23540,29.4807065,-82.6274667,private,0,0,14,0,0,14,14,0,0,11,0,0,11,11,3
33460,45.096664,-93.275361,34740,43.2892579,-86.751892,private,0,0,14,0,0,14,14,0,0,13,0,0,13,13,3.001246706
33460,45.096664,-93.275361,43580,42.5129417,-96.4389491,private,0,0,14,0,0,14,14,0,0,12,0,0,12,12,3.000623353
33460,45.096664,-93.275361,40300,42.041884,-89.3201764,private,0,0,14,0,0,14,14,0,0,11,0,0,11,11,3
33460,45.096664,-93.275361,42200,34.5370572,-120.0399729,private,0,0,14,0,0,14,14,0,11,0,0,11,0,11,3
33460,45.096664,-93.275361,44060,48.091618,-117.663472,private,0,0,14,0,0,14,14,0,0,25,0,0,25,25,3.008726943
16980,41.8235214,-87.8282967,48180,31.1331137,-82.3686504,private,0,0,14,0,0,14,14,0,0,12,0,0,12,12,3.000623353
16980,41.8235214,-87.8282967,24020,43.4404503,-73.6367573,private,0,0,14,0,0,14,14,0,0,13,0,0,13,13,3.001246706
16980,41.8235214,-87.8282967,25620,31.2737661,-89.3006335,private,0,0,14,0,0,14,14,0,0,14,0,0,14,14,3.001870059
19100,32.8491708,-96.9704894,31740,39.2684241,-96.5622422,private,0,0,14,0,0,14,14,0,0,27,0,0,27,27,3.009973649
19100,32.8491708,-96.9704894,26380,29.3341299,-90.8436739,private,0,0,14,0,0,14,14,0,0,13,0,0,13,13,3.001246706
19100,32.8491708,-96.9704894,31460,37.2098213,-119.7498023,private,0,0,14,0,0,14,14,0,0,25,0,0,25,25,3.008726943
26420,29.7495926,-95.3536422,34740,43.2892579,-86.751892,private,0,0,25,0,0,25,25,0,0,11,0,0,11,11,3
38060,33.1857653,-112.0678624,42340,32.1091533,-81.2731066,private,0,0,25,0,0,25,25,0,0,25,0,0,25,25,3.008726943
38060,33.1857653,-112.0678624,30020,34.5291104,-98.4309172,private,0,0,27,0,0,27,27,0,0,24,0,0,24,24,3.00810359
49740,32.7739424,-113.910905,29060,43.5191091,-71.4253661,private,0,14,0,0,14,0,14,0,14,0,0,14,0,14,3.001870059
49740,32.7739424,-113.910905,24660,36.0252039,-79.7926333,private,0,0,37,0,0,37,37,0,0,12,0,0,12,12,3.000623353
49740,32.7739424,-113.910905,17780,30.7543917,-96.4885368,private,0,0,14,0,0,14,14,0,0,14,0,0,14,14,3.001870059
49740,32.7739424,-113.910905,23700,35.5838784,-108.2532659,private,0,0,14,0,0,14,14,0,0,12,0,0,12,12,3.000623353
31080,34.1087033,-118.1827533,31420,32.8562163,-83.714305,private,0,0,14,0,0,14,14,0,0,11,0,0,11,11,3
41860,37.7737185,-122.2744317,29460,27.9536488,-81.6935337,private,0,0,14,0,0,14,14,0,0,12,0,0,12,12,3.000623353
34580,48.4932917,-121.8157703,21700,40.7066554,-123.9261757,private,0,0,14,0,0,14,14,0,0,14,0,0,14,14,3.001870059
43220,47.3541257,-123.1738498,48140,45.0539796,-89.7579047,private,0,0,14,0,0,14,14,0,0,13,0,0,13,13,3.001246706
14460,42.517606,-71.0219925,37120,31.4306536,-85.609476,private,0,0,0,0,0,0,0,0,0,14,0,0,14,14,3.001870059
14460,42.517606,-71.0219925,33540,47.0272632,-113.8926911,private,0,0,0,0,0,0,0,0,0,14,0,0,14,14,3.001870059
14460,42.517606,-71.0219925,12540,35.3466288,-118.7295064,private,0,0,0,0,0,0,0,0,0,14,0,0,14,14,3.001870059
35620,40.77493,-73.873758,21500,42.1179519,-80.0963858,private,0,0,0,0,0,0,0,0,0,14,0,0,14,14,3.001870059
35620,40.77493,-73.873758,15940,40.7110505,-81.261468,private,0,0,0,0,0,0,0,0,0,41,0,0,41,41,3.018700592
35620,40.77493,-73.873758,38500,41.3250032,-86.2690363,private,0,0,0,0,0,0,0,0,0,25,0,0,25,25,3.008726943
35620,40.77493,-73.873758,36260,41.276061,-113.126226,private,0,0,0,0,0,0,0,0,0,14,0,0,14,14,3.001870059
37980,39.8949576,-75.3119824,18260,36.2772512,-85.4685013,private,0,0,0,0,0,0,0,0,0,14,0,0,14,14,3.001870059
37980,39.8949576,-75.3119824,26620,34.7832617,-86.7348706,private,0,0,13,0,0,13,13,0,0,14,0,0,14,14,3.001870059
37980,39.8949576,-75.3119824,16300,42.0863293,-91.6311439,private,0,0,0,0,0,0,0,0,0,25,0,0,25,25,3.008726943
37980,39.8949576,-75.3119824,17780,30.7543917,-96.4885368,private,0,0,0,0,0,0,0,0,0,14,0,0,14,14,3.001870059
37980,39.8949576,-75.3119824,21340,31.527394,-105.5213326,private,0,0,13,0,0,13,13,0,0,14,0,0,14,14,3.001870059
37980,39.8949576,-75.3119824,37100,34.3587415,-119.1331432,private,0,0,0,0,0,0,0,0,0,14,0,0,14,14,3.001870059
37980,39.8949576,-75.3119824,33700,37.5623162,-121.0028311,private,0,0,0,0,0,0,0,0,0,14,0,0,14,14,3.001870059
37980,39.8949576,-75.3119824,46520,21.5800225,-158.1234063,private,0,0,13,0,0,13,13,0,0,14,0,0,14,14,3.001870059
47900,38.7982054,-77.4868816,43620,43.4954205,-96.9953387,private,0,0,11,0,0,11,11,0,0,14,0,0,14,14,3.001870059
47900,38.7982054,-77.4868816,17860,38.9864864,-92.5851888,private,0,0,0,0,0,0,0,0,0,14,0,0,14,14,3.001870059
12060,33.693728,-84.3999113,12700,41.7990145,-70.2118803,private,0,0,0,0,0,0,0,0,26,25,0,26,25,51,3.024934123
12060,33.693728,-84.3999113,47220,39.3284336,-75.1216277,private,0,0,11,0,0,11,11,0,0,14,0,0,14,14,3.001870059
12060,33.693728,-84.3999113,37900,40.7088872,-89.6974658,private,0,0,35,0,0,35,35,0,0,14,0,0,14,14,3.001870059
12060,33.693728,-84.3999113,30020,34.5291104,-98.4309172,private,0,0,0,0,0,0,0,0,0,14,0,0,14,14,3.001870059
12060,33.693728,-84.3999113,21060,37.7329803,-85.9721707,private,0,0,11,0,0,11,11,0,0,37,0,0,37,37,3.01620718
12060,33.693728,-84.3999113,18500,42.2667252,-77.3855253,private,0,0,34,0,0,34,34,0,0,26,0,0,26,26,3.009350296
33100,26.1018281,-80.4787552,36460,42.2390986,-78.662332,private,0,13,0,0,13,0,13,0,14,0,0,14,0,14,3.001870059
33100,26.1018281,-80.4787552,25500,38.5075848,-78.8853213,private,0,0,0,0,0,0,0,0,0,14,0,0,14,14,3.001870059
33100,26.1018281,-80.4787552,22020,46.9148591,-96.9601826,private,0,0,0,0,0,0,0,0,0,14,0,0,14,14,3.001870059
33100,26.1018281,-80.4787552,27300,39.6939496,-90.2850474,private,0,0,0,0,0,0,0,0,0,14,0,0,14,14,3.001870059
33100,26.1018281,-80.4787552,22900,35.4631192,-94.2997413,private,0,0,0,0,0,0,0,0,0,14,0,0,14,14,3.001870059
33100,26.1018281,-80.4787552,39820,40.7605142,-122.0435556,private,0,0,0,0,0,0,0,0,0,14,0,0,14,14,3.001870059
33100,26.1018281,-80.4787552,21780,38.0200703,-87.5861659,private,0,0,0,0,0,0,0,0,0,14,0,0,14,14,3.001870059
33100,26.1018281,-80.4787552,23420,36.7610058,-119.6550193,private,0,0,0,0,0,0,0,0,0,14,0,0,14,14,3.001870059
33460,45.096664,-93.275361,25460,36.0878092,-93.1620533,private,0,0,0,0,0,0,0,0,0,14,0,0,14,14,3.001870059
33460,45.096664,-93.275361,13820,33.4025986,-86.7295151,private,0,0,13,0,0,13,13,0,0,14,0,0,14,14,3.001870059
16980,41.8235214,-87.8282967,29980,35.2204764,-87.396546,private,0,0,13,0,0,13,13,0,0,14,0,0,14,14,3.001870059
16980,41.8235214,-87.8282967,38340,42.371493,-73.2179276,private,0,0,0,0,0,0,0,0,0,14,0,0,14,14,3.001870059
16980,41.8235214,-87.8282967,36300,44.4881125,-75.074311,private,0,0,0,0,0,0,0,0,0,14,0,0,14,14,3.001870059
16980,41.8235214,-87.8282967,20660,38.7483486,-76.1784757,private,0,0,0,0,0,0,0,0,0,14,0,0,14,14,3.001870059
16980,41.8235214,-87.8282967,46660,30.8271579,-83.2435547,private,0,0,0,0,0,0,0,0,0,14,0,0,14,14,3.001870059
16980,41.8235214,-87.8282967,39660,44.3154852,-102.7683833,private,0,0,0,0,0,0,0,0,0,26,0,0,26,26,3.009350296
16980,41.8235214,-87.8282967,25740,46.8113536,-112.2840307,private,0,0,0,0,0,0,0,0,0,14,0,0,14,14,3.001870059
16980,41.8235214,-87.8282967,28060,48.3146779,-114.0542951,private,0,0,0,0,0,0,0,0,0,14,0,0,14,14,3.001870059
16980,41.8235214,-87.8282967,17660,47.6759658,-116.6959222,private,0,0,0,0,0,0,0,0,0,14,0,0,14,14,3.001870059
19100,32.8491708,-96.9704894,10380,18.3569648,-67.0078951,private,0,0,13,0,0,13,13,0,0,27,0,0,27,27,3.009973649
19100,32.8491708,-96.9704894,22020,46.9148591,-96.9601826,private,0,0,0,0,0,0,0,0,0,14,0,0,14,14,3.001870059
19100,32.8491708,-96.9704894,12540,35.3466288,-118.7295064,private,0,0,26,0,0,26,26,14,0,12,0,0,26,26,3.009350296
19100,32.8491708,-96.9704894,23420,36.7610058,-119.6550193,private,0,0,12,0,0,12,12,0,0,28,0,0,28,28,3.010597002
26420,29.7495926,-95.3536422,16300,42.0863293,-91.6311439,private,0,0,0,0,0,0,0,0,0,14,0,0,14,14,3.001870059
26420,29.7495926,-95.3536422,32780,42.4116214,-122.6756106,private,0,0,12,0,0,12,12,0,0,14,0,0,14,14,3.001870059
20900,29.2784805,-96.2296745,34940,26.118786,-81.4009553,private,0,0,12,0,0,12,12,0,0,14,0,0,14,14,3.001870059
20900,29.2784805,-96.2296745,15140,35.5866782,-89.2826913,private,0,0,0,0,0,0,0,0,0,14,0,0,14,14,3.001870059
20900,29.2784805,-96.2296745,36540,41.2904587,-95.9999701,private,0,0,11,0,0,11,11,0,0,14,0,0,14,14,3.001870059
20900,29.2784805,-96.2296745,21580,36.5096687,-106.6939829,private,0,0,0,0,0,0,0,0,0,14,0,0,14,14,3.001870059
20900,29.2784805,-96.2296745,33700,37.5623162,-121.0028311,private,0,0,0,0,0,0,0,0,0,14,0,0,14,14,3.001870059
26420,29.7495926,-95.3536422,27740,36.2658223,-82.3326926,private,0,0,24,0,0,24,24,0,0,26,0,0,26,26,3.009350296
38060,33.1857653,-112.0678624,22900,35.4631192,-94.2997413,private,0,0,12,0,0,12,12,0,0,14,0,0,14,14,3.001870059
38060,33.1857653,-112.0678624,18580,27.8335972,-97.5089575,private,0,0,25,0,0,25,25,0,0,28,0,0,28,28,3.010597002
38060,33.1857653,-112.0678624,47380,31.4272264,-97.0934727,private,0,0,0,0,0,0,0,0,0,26,0,0,26,26,3.009350296
49740,32.7739424,-113.910905,35980,41.4726517,-72.1086339,private,0,0,0,0,0,0,0,0,0,14,0,0,14,14,3.001870059
49740,32.7739424,-113.910905,10500,31.6444531,-84.1119078,private,0,0,0,0,0,0,0,0,0,14,0,0,14,14,3.001870059
31080,34.1087033,-118.1827533,29060,43.5191091,-71.4253661,private,0,0,0,0,0,0,0,0,0,14,0,0,14,14,3.001870059
31080,34.1087033,-118.1827533,15680,38.2202894,-76.5303837,private,0,0,11,0,0,11,11,0,0,14,0,0,14,14,3.001870059
31080,34.1087033,-118.1827533,12260,33.4603713,-81.9828327,private,0,0,0,0,0,0,0,0,0,14,0,0,14,14,3.001870059
31080,34.1087033,-118.1827533,25060,30.4801526,-88.9992972,private,0,0,11,0,0,11,11,0,0,26,0,0,26,26,3.009350296
31080,34.1087033,-118.1827533,15620,44.3287385,-85.3264287,private,0,0,0,0,0,0,0,0,0,14,0,0,14,14,3.001870059
41860,37.7737185,-122.2744317,25940,32.3867916,-80.8308775,private,0,0,0,0,0,0,0,0,0,14,0,0,14,14,3.001870059
41860,37.7737185,-122.2744317,25060,30.4801526,-88.9992972,private,0,0,0,0,0,0,0,0,0,14,0,0,14,14,3.001870059
41860,37.7737185,-122.2744317,10420,41.1466395,-81.3501104,private,0,0,0,0,0,0,0,0,0,14,0,0,14,14,3.001870059
41860,37.7737185,-122.2744317,29620,42.7712334,-84.4960294,private,0,0,0,0,0,0,0,0,0,14,0,0,14,14,3.001870059
41860,37.7737185,-122.2744317,48580,42.6681095,-88.5417306,private,0,0,0,0,0,0,0,0,0,14,0,0,14,14,3.001870059
41860,37.7737185,-122.2744317,16580,40.1029885,-88.3185039,private,0,0,13,0,0,13,13,0,0,25,0,0,25,25,3.008726943
42660,47.4905993,-121.833996,10900,40.7893392,-75.398158,private,0,0,12,0,0,12,12,0,0,14,0,0,14,14,3.001870059
42660,47.4905993,-121.833996,15140,35.5866782,-89.2826913,private,0,0,0,0,0,0,0,0,0,25,0,0,25,25,3.008726943
42660,47.4905993,-121.833996,20740,44.9386719,-91.2843222,private,0,0,0,0,0,0,0,0,0,14,0,0,14,14,3.001870059
42660,47.4905993,-121.833996,39100,41.5752737,-74.0338729,private,0,0,22,0,0,22,22,0,0,14,0,0,14,14,3.001870059
34580,48.4932917,-121.8157703,48900,34.4260331,-77.889634,private,0,0,0,0,0,0,0,0,0,14,0,0,14,14,3.001870059
34580,48.4932917,-121.8157703,48140,45.0539796,-89.7579047,private,0,0,0,0,0,0,0,0,0,14,0,0,14,14,3.001870059
34580,48.4932917,-121.8157703,46340,32.3770156,-95.2700409,private,0,0,0,0,0,0,0,0,0,14,0,0,14,14,3.001870059
34580,48.4932917,-121.8157703,29660,41.6655141,-105.7218826,private,0,0,0,0,0,0,0,0,0,14,0,0,14,14,3.001870059
34580,48.4932917,-121.8157703,28540,55.4499378,-131.1066847,private,0,0,12,0,0,12,12,0,0,14,0,0,14,14,3.001870059
43220,47.3541257,-123.1738498,43900,34.9332708,-81.9910522,private,0,0,0,0,0,0,0,14,0,0,0,0,14,14,3.001870059
43220,47.3541257,-123.1738498,44180,37.3608699,-93.1802617,private,0,0,0,0,0,0,0,0,0,14,0,0,14,14,3.001870059
43220,47.3541257,-123.1738498,19700,32.1845231,-107.7471911,private,0,0,0,0,0,0,0,0,0,14,0,0,14,14,3.001870059
42660,47.4905993,-121.833996,35100,35.1168292,-77.0813197,private,0,0,11,0,0,11,11,0,0,26,0,0,26,26,3.009350296
35620,40.77493,-73.873758,17860,38.9864864,-92.5851888,private,0,0,13,0,0,13,13,0,0,11,0,0,11,11,3
47900,38.7982054,-77.4868816,29940,38.8964168,-95.2909475,private,0,0,13,0,0,13,13,0,0,11,0,0,11,11,3
33460,45.096664,-93.275361,24540,40.555961,-104.383666,private,0,0,24,0,0,24,24,0,0,11,0,0,11,11,3
33460,45.096664,-93.275361,20220,42.4634808,-90.8787708,private,0,0,24,0,0,24,24,0,0,12,0,0,12,12,3.000623353
33460,45.096664,-93.275361,38860,43.6514172,-70.4183755,private,0,0,25,0,0,25,25,0,0,24,0,0,24,24,3.00810359
16980,41.8235214,-87.8282967,35980,41.4726517,-72.1086339,private,0,0,13,0,0,13,13,0,0,11,0,0,11,11,3
16980,41.8235214,-87.8282967,31180,33.4703271,-101.6488249,private,0,0,13,0,0,13,13,0,0,12,0,0,12,12,3.000623353
19100,32.8491708,-96.9704894,41460,38.9645697,-97.6633868,private,0,0,13,0,0,13,13,0,0,12,0,0,12,12,3.000623353
26420,29.7495926,-95.3536422,17860,38.9864864,-92.5851888,private,0,0,13,0,0,13,13,0,0,12,0,0,12,12,3.000623353
26420,29.7495926,-95.3536422,42020,35.3852242,-120.4475445,private,0,0,13,0,0,13,13,0,0,11,0,0,11,11,3
20900,29.2784805,-96.2296745,10180,32.4520222,-99.7187428,private,0,0,13,0,0,13,13,0,0,11,0,0,11,11,3
26420,29.7495926,-95.3536422,25460,36.0878092,-93.1620533,private,0,0,13,0,0,13,13,11,0,12,0,0,23,23,3.007480237
38060,33.1857653,-112.0678624,29180,29.9577733,-92.0493498,private,0,0,13,0,0,13,13,0,0,24,0,0,24,24,3.00810359
49740,32.7739424,-113.910905,45060,43.0065163,-76.1961336,private,0,0,24,0,0,24,24,0,11,0,0,11,0,11,3
49740,32.7739424,-113.910905,27420,46.9722235,-98.9561228,private,0,13,0,0,13,0,13,0,13,0,0,13,0,13,3.001246706
49740,32.7739424,-113.910905,38780,34.0212068,-103.4830039,private,0,0,13,0,0,13,13,0,0,12,0,0,12,12,3.000623353
42660,47.4905993,-121.833996,42340,32.1091533,-81.2731066,private,0,0,13,0,0,13,13,0,0,26,0,0,26,26,3.009350296
42660,47.4905993,-121.833996,36100,29.2028047,-82.0431004,private,0,0,25,0,0,25,25,0,0,23,0,0,23,23,3.007480237
42660,47.4905993,-121.833996,29180,29.9577733,-92.0493498,private,0,0,13,0,0,13,13,0,0,12,0,0,12,12,3.000623353
42660,47.4905993,-121.833996,24300,39.019524,-108.4605707,private,0,0,13,0,0,13,13,0,0,11,0,0,11,11,3
43220,47.3541257,-123.1738498,40620,37.8663263,-91.7903492,private,0,0,13,0,0,13,13,0,0,11,0,0,11,11,3
14460,42.517606,-71.0219925,49020,39.2729744,-78.4718276,private,0,0,0,0,0,0,0,0,0,13,0,0,13,13,3.001246706
14460,42.517606,-71.0219925,29940,38.8964168,-95.2909475,private,0,0,0,0,0,0,0,0,0,13,0,0,13,13,3.001246706
14460,42.517606,-71.0219925,48620,37.637896,-97.2462875,private,0,0,0,0,0,0,0,0,0,13,0,0,13,13,3.001246706
14460,42.517606,-71.0219925,23420,36.7610058,-119.6550193,private,0,0,0,0,0,0,0,0,0,13,0,0,13,13,3.001246706
35620,40.77493,-73.873758,48700,41.3438824,-77.0552624,private,0,0,0,0,0,0,0,0,0,13,0,0,13,13,3.001246706
35620,40.77493,-73.873758,48180,31.1331137,-82.3686504,private,0,0,12,0,0,12,12,0,0,24,0,0,24,24,3.00810359
35620,40.77493,-73.873758,39660,44.3154852,-102.7683833,private,0,0,0,0,0,0,0,0,0,13,0,0,13,13,3.001246706
35620,40.77493,-73.873758,16540,39.9267722,-77.7245208,private,0,0,0,0,0,0,0,0,0,13,0,0,13,13,3.001246706
35620,40.77493,-73.873758,12300,44.4170119,-69.7657639,private,0,0,0,0,0,0,0,0,0,13,0,0,13,13,3.001246706
35620,40.77493,-73.873758,40300,42.041884,-89.3201764,private,0,0,0,0,0,0,0,0,0,13,0,0,13,13,3.001246706
35620,40.77493,-73.873758,31460,37.2098213,-119.7498023,private,0,0,0,0,0,0,0,0,0,13,0,0,13,13,3.001246706
35620,40.77493,-73.873758,28420,46.3639636,-119.2540459,private,0,0,0,0,0,0,0,0,0,13,0,0,13,13,3.001246706
37980,39.8949576,-75.3119824,40860,43.5808577,-73.0382023,private,0,0,0,0,0,0,0,0,0,13,0,0,13,13,3.001246706
37980,39.8949576,-75.3119824,22220,36.1163935,-94.0795449,private,0,0,0,0,0,0,0,0,0,13,0,0,13,13,3.001246706
47900,38.7982054,-77.4868816,34060,39.5251551,-79.8019121,private,0,0,0,0,0,0,0,0,0,13,0,0,13,13,3.001246706
47900,38.7982054,-77.4868816,25980,31.7787881,-81.5764801,private,0,0,0,0,0,0,0,0,0,13,0,0,13,13,3.001246706
47900,38.7982054,-77.4868816,36100,29.2028047,-82.0431004,private,0,0,0,0,0,0,0,0,0,13,0,0,13,13,3.001246706
47900,38.7982054,-77.4868816,42460,34.764114,-85.9800556,private,0,0,0,0,0,0,0,0,0,13,0,0,13,13,3.001246706
47900,38.7982054,-77.4868816,16860,35.0493612,-85.3611582,private,0,0,0,0,0,0,0,0,0,13,0,0,13,13,3.001246706
47900,38.7982054,-77.4868816,17660,47.6759658,-116.6959222,private,0,0,0,0,0,0,0,0,0,13,0,0,13,13,3.001246706
47900,38.7982054,-77.4868816,44060,48.091618,-117.663472,private,0,0,0,0,0,0,0,0,0,13,0,0,13,13,3.001246706
12060,33.693728,-84.3999113,31700,42.9115317,-71.7230554,private,0,0,24,0,0,24,24,0,0,24,0,0,24,24,3.00810359
12060,33.693728,-84.3999113,10300,41.8960225,-84.0743563,private,0,0,22,0,0,22,22,0,0,13,0,0,13,13,3.001246706
33100,26.1018281,-80.4787552,17780,30.7543917,-96.4885368,private,0,0,11,0,0,11,11,0,0,13,0,0,13,13,3.001246706
33100,26.1018281,-80.4787552,32780,42.4116214,-122.6756106,private,0,0,0,0,0,0,0,0,0,25,0,0,25,25,3.008726943
33460,45.096664,-93.275361,28060,48.3146779,-114.0542951,private,0,0,12,0,0,12,12,0,0,13,0,0,13,13,3.001246706
33460,45.096664,-93.275361,45780,41.5553128,-83.5170883,private,0,0,0,0,0,0,0,0,0,13,0,0,13,13,3.001246706
33460,45.096664,-93.275361,37100,34.3587415,-119.1331432,private,0,0,11,0,0,11,11,0,0,13,0,0,13,13,3.001246706
16980,41.8235214,-87.8282967,17980,32.4193768,-84.8437095,private,0,0,12,0,0,12,12,0,0,25,0,0,25,25,3.008726943
16980,41.8235214,-87.8282967,13740,45.6371402,-108.8323611,private,0,0,0,0,0,0,0,0,0,13,0,0,13,13,3.001246706
16980,41.8235214,-87.8282967,45000,40.7210862,-120.6299518,private,0,0,0,0,0,0,0,0,0,13,0,0,13,13,3.001246706
19100,32.8491708,-96.9704894,45060,43.0065163,-76.1961336,private,0,0,24,0,0,24,24,0,0,13,0,0,13,13,3.001246706
19100,32.8491708,-96.9704894,39660,44.3154852,-102.7683833,private,0,0,0,0,0,0,0,0,0,13,0,0,13,13,3.001246706
19100,32.8491708,-96.9704894,12700,41.7990145,-70.2118803,private,0,0,0,0,0,0,0,0,13,0,0,13,0,13,3.001246706
26420,29.7495926,-95.3536422,38340,42.371493,-73.2179276,private,0,0,0,0,0,0,0,0,0,13,0,0,13,13,3.001246706
26420,29.7495926,-95.3536422,18500,42.2667252,-77.3855253,private,0,0,0,0,0,0,0,0,0,13,0,0,13,13,3.001246706
26420,29.7495926,-95.3536422,24580,44.4740244,-87.9961303,private,0,0,0,0,0,0,0,0,0,13,0,0,13,13,3.001246706
20900,29.2784805,-96.2296745,17140,39.0998213,-84.4804072,private,0,0,12,0,0,12,12,0,0,13,0,0,13,13,3.001246706
20900,29.2784805,-96.2296745,14260,43.0066485,-116.1419089,private,0,0,0,0,0,0,0,0,0,13,0,0,13,13,3.001246706
38060,33.1857653,-112.0678624,12020,33.943984,-83.2138965,private,0,0,12,0,0,12,12,0,0,13,0,0,13,13,3.001246706
38060,33.1857653,-112.0678624,31420,32.8562163,-83.714305,private,0,0,11,0,0,11,11,0,0,13,0,0,13,13,3.001246706
38060,33.1857653,-112.0678624,33860,32.3656313,-86.4045848,private,0,0,0,0,0,0,0,0,0,13,0,0,13,13,3.001246706
38060,33.1857653,-112.0678624,21220,40.9060857,-115.5545775,private,0,0,0,0,0,0,0,0,0,13,0,0,13,13,3.001246706
38060,33.1857653,-112.0678624,16540,39.9267722,-77.7245208,private,0,0,0,0,0,0,0,0,0,13,0,0,13,13,3.001246706
38060,33.1857653,-112.0678624,49620,39.9217514,-76.7288887,private,0,0,0,0,0,0,0,0,0,13,0,0,13,13,3.001246706
38060,33.1857653,-112.0678624,48180,31.1331137,-82.3686504,private,0,0,0,0,0,0,0,0,0,13,0,0,13,13,3.001246706
38060,33.1857653,-112.0678624,17980,32.4193768,-84.8437095,private,0,0,0,0,0,0,0,0,0,13,0,0,13,13,3.001246706
49740,32.7739424,-113.910905,21500,42.1179519,-80.0963858,private,0,0,11,0,0,11,11,0,0,13,0,0,13,13,3.001246706
49740,32.7739424,-113.910905,19460,34.4893614,-87.0971469,private,0,0,0,0,0,0,0,0,0,13,0,0,13,13,3.001246706
49740,32.7739424,-113.910905,36900,41.0312751,-92.4094658,private,0,0,0,0,0,0,0,0,0,13,0,0,13,13,3.001246706
49740,32.7739424,-113.910905,45380,39.5455242,-89.2795927,private,0,0,0,0,0,0,0,0,0,13,0,0,13,13,3.001246706
49740,32.7739424,-113.910905,34780,35.6175506,-95.3839106,private,0,0,0,0,0,0,0,0,0,13,0,0,13,13,3.001246706
49740,32.7739424,-113.910905,30300,46.2516957,-116.9250166,private,0,11,0,0,11,0,11,0,13,0,0,13,0,13,3.001246706
31080,34.1087033,-118.1827533,10380,18.3569648,-67.0078951,private,0,0,0,0,0,0,0,0,0,13,0,0,13,13,3.001246706
31080,34.1087033,-118.1827533,33660,30.9715095,-88.20787,private,0,0,0,0,0,0,0,0,0,13,0,0,13,13,3.001246706
31080,34.1087033,-118.1827533,10300,41.8960225,-84.0743563,private,0,0,0,0,0,0,0,0,0,13,0,0,13,13,3.001246706
31080,34.1087033,-118.1827533,24580,44.4740244,-87.9961303,private,0,0,0,0,0,0,0,0,0,25,0,0,25,25,3.008726943
31080,34.1087033,-118.1827533,37940,40.7728833,-86.0442575,private,0,0,0,0,0,0,0,0,0,13,0,0,13,13,3.001246706
41860,37.7737185,-122.2744317,20660,38.7483486,-76.1784757,private,0,0,0,0,0,0,0,0,0,13,0,0,13,13,3.001246706
41860,37.7737185,-122.2744317,42340,32.1091533,-81.2731066,private,0,0,0,0,0,0,0,0,0,13,0,0,13,13,3.001246706
41860,37.7737185,-122.2744317,28940,36.0147907,-84.2067014,private,0,0,0,0,0,0,0,0,0,13,0,0,13,13,3.001246706
41860,37.7737185,-122.2744317,40340,43.9496362,-92.3360701,private,0,0,12,0,0,12,12,0,0,13,0,0,13,13,3.001246706
41860,37.7737185,-122.2744317,48620,37.637896,-97.2462875,private,0,0,0,0,0,0,0,0,0,13,0,0,13,13,3.001246706
41860,37.7737185,-122.2744317,12940,30.5187808,-91.1255901,private,0,0,0,0,0,0,0,0,0,13,0,0,13,13,3.001246706
42660,47.4905993,-121.833996,12940,30.5187808,-91.1255901,private,0,0,23,0,0,23,23,0,0,13,0,0,13,13,3.001246706
42660,47.4905993,-121.833996,31700,42.9115317,-71.7230554,private,0,0,11,0,0,11,11,0,0,13,0,0,13,13,3.001246706
42660,47.4905993,-121.833996,44300,40.9091275,-77.8478769,private,0,0,0,0,0,0,0,0,0,13,0,0,13,13,3.001246706
42660,47.4905993,-121.833996,25940,32.3867916,-80.8308775,private,0,0,0,0,0,0,0,0,0,13,0,0,13,13,3.001246706
42660,47.4905993,-121.833996,20260,47.3475056,-92.1553326,private,0,0,11,0,0,11,11,0,0,13,0,0,13,13,3.001246706
34580,48.4932917,-121.8157703,24660,36.0252039,-79.7926333,private,0,0,0,0,0,0,0,0,0,13,0,0,13,13,3.001246706
34580,48.4932917,-121.8157703,16860,35.0493612,-85.3611582,private,0,0,0,0,0,0,0,0,0,13,0,0,13,13,3.001246706
34580,48.4932917,-121.8157703,18140,39.9685617,-82.8359105,private,0,0,0,0,0,0,0,0,0,13,0,0,13,13,3.001246706
34580,48.4932917,-121.8157703,23060,41.1131166,-85.2177047,private,0,0,0,0,0,0,0,0,0,13,0,0,13,13,3.001246706
34580,48.4932917,-121.8157703,28020,42.2462657,-85.5328544,private,0,0,11,0,0,11,11,0,0,13,0,0,13,13,3.001246706
34580,48.4932917,-121.8157703,48780,48.3557649,-103.5013332,private,0,0,0,0,0,0,0,0,0,13,0,0,13,13,3.001246706
34580,48.4932917,-121.8157703,42200,34.5370572,-120.0399729,private,0,0,0,0,0,0,0,0,0,13,0,0,13,13,3.001246706
43220,47.3541257,-123.1738498,10580,42.7879202,-73.9423479,private,0,0,0,0,0,0,0,13,0,0,0,0,13,13,3.001246706
43220,47.3541257,-123.1738498,12260,33.4603713,-81.9828327,private,0,0,0,0,0,0,0,0,0,25,0,0,25,25,3.008726943
43220,47.3541257,-123.1738498,28020,42.2462657,-85.5328544,private,0,0,0,0,0,0,0,0,0,13,0,0,13,13,3.001246706
43220,47.3541257,-123.1738498,27900,37.0555457,-94.3397364,private,0,0,0,0,0,0,0,0,0,13,0,0,13,13,3.001246706
43220,47.3541257,-123.1738498,24540,40.555961,-104.383666,private,0,0,0,0,0,0,0,0,0,13,0,0,13,13,3.001246706
43220,47.3541257,-123.1738498,29660,41.6655141,-105.7218826,private,0,0,11,0,0,11,11,0,0,13,0,0,13,13,3.001246706
42660,47.4905993,-121.833996,22140,36.5116245,-108.3245778,private,0,0,0,0,0,0,0,0,0,13,0,0,13,13,3.001246706
14460,42.517606,-71.0219925,19780,41.5770501,-93.7597124,private,0,0,12,0,0,12,12,0,0,12,0,0,12,12,3.000623353
35620,40.77493,-73.873758,44180,37.3608699,-93.1802617,private,0,0,12,0,0,12,12,0,0,11,0,0,11,11,3
37980,39.8949576,-75.3119824,19780,41.5770501,-93.7597124,private,0,0,12,0,0,12,12,0,0,12,0,0,12,12,3.000623353
37980,39.8949576,-75.3119824,40340,43.9496362,-92.3360701,private,0,0,12,0,0,12,12,0,0,11,0,0,11,11,3
12060,33.693728,-84.3999113,12540,35.3466288,-118.7295064,private,12,0,11,0,0,23,23,0,0,11,0,0,11,11,3
12060,33.693728,-84.3999113,40700,43.2863277,-123.154476,private,0,0,23,0,0,23,23,0,0,12,0,0,12,12,3.000623353
33460,45.096664,-93.275361,13740,45.6371402,-108.8323611,private,0,0,23,0,0,23,23,0,0,11,0,0,11,11,3
33460,45.096664,-93.275361,40380,43.148038,-77.5232575,private,0,0,23,0,0,23,23,0,0,12,0,0,12,12,3.000623353
16980,41.8235214,-87.8282967,33940,38.3425479,-108.1622366,private,0,0,12,0,0,12,12,0,0,12,0,0,12,12,3.000623353
19100,32.8491708,-96.9704894,48180,31.1331137,-82.3686504,private,0,0,12,0,0,12,12,0,0,12,0,0,12,12,3.000623353
19100,32.8491708,-96.9704894,12220,32.6040644,-85.3530477,private,0,0,12,0,0,12,12,0,0,24,0,0,24,24,3.00810359
19100,32.8491708,-96.9704894,36260,41.276061,-113.126226,private,0,0,12,0,0,12,12,0,0,11,0,0,11,11,3
19100,32.8491708,-96.9704894,44140,42.3648332,-72.6194063,private,0,0,23,0,0,23,23,0,0,12,0,0,12,12,3.000623353
26420,29.7495926,-95.3536422,46220,33.0978758,-87.7991533,private,0,0,12,0,0,12,12,0,0,11,0,0,11,11,3
26420,29.7495926,-95.3536422,13740,45.6371402,-108.8323611,private,0,0,12,0,0,12,12,0,0,12,0,0,12,12,3.000623353
38060,33.1857653,-112.0678624,37120,31.4306536,-85.609476,private,0,0,12,0,0,12,12,0,0,11,0,0,11,11,3
38060,33.1857653,-112.0678624,18260,36.2772512,-85.4685013,private,0,0,12,0,0,12,12,0,0,11,0,0,11,11,3
38060,33.1857653,-112.0678624,14540,37.0468241,-86.3970408,private,0,0,12,0,0,12,12,11,0,0,0,0,11,11,3
38060,33.1857653,-112.0678624,45380,39.5455242,-89.2795927,private,12,0,11,0,0,23,23,0,0,11,0,0,11,11,3
49740,32.7739424,-113.910905,25980,31.7787881,-81.5764801,private,0,0,12,0,0,12,12,0,0,11,0,0,11,11,3
49740,32.7739424,-113.910905,35660,41.7913818,-86.7425435,private,0,12,0,0,12,0,12,0,11,0,0,11,0,11,3
49740,32.7739424,-113.910905,40180,43.054831,-108.6089349,private,0,12,0,0,12,0,12,0,12,0,0,12,0,12,3.000623353
31080,34.1087033,-118.1827533,30100,43.7857256,-72.1591415,private,0,0,12,0,0,12,12,0,0,12,0,0,12,12,3.000623353
42660,47.4905993,-121.833996,12700,41.7990145,-70.2118803,private,0,0,12,0,0,12,12,0,0,11,0,0,11,11,3
14460,42.517606,-71.0219925,31340,37.3649258,-79.2166894,private,0,0,0,0,0,0,0,0,0,12,0,0,12,12,3.000623353
14460,42.517606,-71.0219925,12260,33.4603713,-81.9828327,private,0,0,11,0,0,11,11,0,0,12,0,0,12,12,3.000623353
14460,42.517606,-71.0219925,25060,30.4801526,-88.9992972,private,0,0,0,0,0,0,0,0,0,12,0,0,12,12,3.000623353
14460,42.517606,-71.0219925,41500,36.240107,-121.3155723,private,0,0,11,0,0,11,11,0,0,12,0,0,12,12,3.000623353
35620,40.77493,-73.873758,16620,38.3551769,-81.6203407,private,0,0,0,0,0,0,0,0,0,12,0,0,12,12,3.000623353
35620,40.77493,-73.873758,43780,41.7749808,-86.1230143,private,0,0,11,0,0,11,11,0,0,12,0,0,12,12,3.000623353
35620,40.77493,-73.873758,22380,35.8296919,-111.7737277,private,0,0,0,0,0,0,0,0,0,12,0,0,12,12,3.000623353
35620,40.77493,-73.873758,21700,40.7066554,-123.9261757,private,0,0,0,0,0,0,0,0,0,23,0,0,23,23,3.007480237
35620,40.77493,-73.873758,44060,48.091618,-117.663472,private,0,0,0,0,0,0,0,0,0,12,0,0,12,12,3.000623353
35620,40.77493,-73.873758,27780,40.5102221,-78.7104783,private,0,0,0,0,0,0,0,0,0,23,0,0,23,23,3.007480237
35620,40.77493,-73.873758,33860,32.3656313,-86.4045848,private,0,0,11,0,0,11,11,0,0,12,0,0,12,12,3.000623353
35620,40.77493,-73.873758,19340,41.3916799,-90.460076,private,0,0,0,0,0,0,0,0,0,12,0,0,12,12,3.000623353
37980,39.8949576,-75.3119824,46140,36.2544287,-96.1773294,private,0,0,0,0,0,0,0,0,0,12,0,0,12,12,3.000623353
37980,39.8949576,-75.3119824,25180,39.5544327,-77.9845935,private,0,0,11,0,0,11,11,0,0,12,0,0,12,12,3.000623353
37980,39.8949576,-75.3119824,31420,32.8562163,-83.714305,private,0,0,0,0,0,0,0,0,0,12,0,0,12,12,3.000623353
37980,39.8949576,-75.3119824,25060,30.4801526,-88.9992972,private,0,0,0,0,0,0,0,0,0,12,0,0,12,12,3.000623353
37980,39.8949576,-75.3119824,29200,40.4821533,-87.0171117,private,0,0,0,0,0,0,0,0,0,12,0,0,12,12,3.000623353
37980,39.8949576,-75.3119824,30780,34.7557726,-92.4005889,private,0,0,11,0,0,11,11,0,0,12,0,0,12,12,3.000623353
37980,39.8949576,-75.3119824,39150,34.631071,-112.5772247,private,0,0,0,0,0,0,0,0,0,12,0,0,12,12,3.000623353
47900,38.7982054,-77.4868816,21020,36.1968134,-76.3426012,private,0,0,0,0,0,0,0,0,0,12,0,0,12,12,3.000623353
47900,38.7982054,-77.4868816,27140,32.4282801,-90.2023875,private,0,0,11,0,0,11,11,0,0,23,0,0,23,23,3.007480237
12060,33.693728,-84.3999113,42540,41.3228806,-75.8981877,private,0,0,0,0,0,0,0,0,0,24,0,0,24,24,3.00810359
12060,33.693728,-84.3999113,27900,37.0555457,-94.3397364,private,0,0,0,0,0,0,0,0,0,12,0,0,12,12,3.000623353
12060,33.693728,-84.3999113,39150,34.631071,-112.5772247,private,0,0,0,0,0,0,0,0,0,12,0,0,12,12,3.000623353
12060,33.693728,-84.3999113,32280,36.3035963,-88.7211938,private,0,0,0,0,0,0,0,0,0,12,0,0,12,12,3.000623353
12060,33.693728,-84.3999113,16060,37.6897419,-89.1051489,private,0,0,0,0,0,0,0,0,0,12,0,0,12,12,3.000623353
33100,26.1018281,-80.4787552,46540,43.3322796,-75.1731893,private,0,0,0,0,0,0,0,0,0,12,0,0,12,12,3.000623353
33100,26.1018281,-80.4787552,42540,41.3228806,-75.8981877,private,0,0,0,0,0,0,0,0,0,12,0,0,12,12,3.000623353
33100,26.1018281,-80.4787552,45780,41.5553128,-83.5170883,private,0,0,0,0,0,0,0,0,0,12,0,0,12,12,3.000623353
33100,26.1018281,-80.4787552,35940,41.1450798,-82.594641,private,0,0,0,0,0,0,0,0,0,12,0,0,12,12,3.000623353
33100,26.1018281,-80.4787552,40420,42.331183,-89.0429139,private,0,0,0,0,0,0,0,0,0,12,0,0,12,12,3.000623353
33100,26.1018281,-80.4787552,44180,37.3608699,-93.1802617,private,0,0,0,0,0,0,0,0,0,12,0,0,12,12,3.000623353
33100,26.1018281,-80.4787552,40700,43.2863277,-123.154476,private,0,0,11,0,0,11,11,0,0,12,0,0,12,12,3.000623353
33460,45.096664,-93.275361,37900,40.7088872,-89.6974658,private,0,0,11,0,0,11,11,0,0,24,0,0,24,24,3.00810359
33460,45.096664,-93.275361,30460,38.1028763,-84.4385451,private,0,0,0,0,0,0,0,0,0,12,0,0,12,12,3.000623353
33460,45.096664,-93.275361,30100,43.7857256,-72.1591415,private,0,0,0,0,0,0,0,0,0,12,0,0,12,12,3.000623353
33460,45.096664,-93.275361,38500,41.3250032,-86.2690363,private,0,0,0,0,0,0,0,0,0,12,0,0,12,12,3.000623353
33460,45.096664,-93.275361,29200,40.4821533,-87.0171117,private,0,0,0,0,0,0,0,0,0,12,0,0,12,12,3.000623353
33460,45.096664,-93.275361,27420,46.9722235,-98.9561228,private,0,0,0,0,0,0,0,0,0,12,0,0,12,12,3.000623353
33460,45.096664,-93.275361,24300,39.019524,-108.4605707,private,0,0,0,0,0,0,0,0,0,12,0,0,12,12,3.000623353
16980,41.8235214,-87.8282967,19460,34.4893614,-87.0971469,private,0,0,0,0,0,0,0,0,0,34,0,0,34,34,3.014337121
16980,41.8235214,-87.8282967,27900,37.0555457,-94.3397364,private,0,0,0,0,0,0,0,0,0,12,0,0,12,12,3.000623353
16980,41.8235214,-87.8282967,10580,42.7879202,-73.9423479,private,0,0,11,0,0,11,11,0,0,24,0,0,24,24,3.00810359
16980,41.8235214,-87.8282967,20700,41.0562401,-75.3290651,private,0,0,0,0,0,0,0,0,0,12,0,0,12,12,3.000623353
16980,41.8235214,-87.8282967,45820,39.0413888,-95.8026393,private,0,0,0,0,0,0,0,0,0,12,0,0,12,12,3.000623353
16980,41.8235214,-87.8282967,43340,32.4376822,-93.7448836,private,0,0,0,0,0,0,0,0,0,12,0,0,12,12,3.000623353
16980,41.8235214,-87.8282967,46340,32.3770156,-95.2700409,private,0,0,0,0,0,0,0,0,0,12,0,0,12,12,3.000623353
16980,41.8235214,-87.8282967,31460,37.2098213,-119.7498023,private,0,0,0,0,0,0,0,0,0,12,0,0,12,12,3.000623353
19100,32.8491708,-96.9704894,36300,44.4881125,-75.074311,private,0,0,0,0,0,0,0,0,0,12,0,0,12,12,3.000623353
19100,32.8491708,-96.9704894,29980,35.2204764,-87.396546,private,0,0,11,0,0,11,11,0,0,24,0,0,24,24,3.00810359
19100,32.8491708,-96.9704894,36900,41.0312751,-92.4094658,private,0,0,0,0,0,0,0,0,0,12,0,0,12,12,3.000623353
19100,32.8491708,-96.9704894,48220,35.6456012,-98.9973857,private,0,0,0,0,0,0,0,0,0,12,0,0,12,12,3.000623353
19100,32.8491708,-96.9704894,22380,35.8296919,-111.7737277,private,0,0,0,0,0,0,0,0,0,12,0,0,12,12,3.000623353
19100,32.8491708,-96.9704894,21700,40.7066554,-123.9261757,private,0,0,0,0,0,0,0,0,0,12,0,0,12,12,3.000623353
19100,32.8491708,-96.9704894,44300,40.9091275,-77.8478769,private,0,0,0,0,0,0,0,0,0,12,0,0,12,12,3.000623353
19100,32.8491708,-96.9704894,42340,32.1091533,-81.2731066,private,0,0,11,0,0,11,11,0,0,23,0,0,23,23,3.007480237
26420,29.7495926,-95.3536422,28060,48.3146779,-114.0542951,private,0,0,0,0,0,0,0,0,12,0,0,12,0,12,3.000623353
26420,29.7495926,-95.3536422,23340,41.5770082,-96.6458526,private,0,0,11,0,0,11,11,0,0,12,0,0,12,12,3.000623353
20900,29.2784805,-96.2296745,40060,37.4113241,-77.4418164,private,0,0,0,0,0,0,0,0,0,12,0,0,12,12,3.000623353
20900,29.2784805,-96.2296745,45500,33.4783701,-94.2071694,private,0,0,0,0,0,0,0,12,0,0,0,0,12,12,3.000623353
20900,29.2784805,-96.2296745,39340,39.872067,-112.3590592,private,0,0,0,0,0,0,0,0,0,12,0,0,12,12,3.000623353
20900,29.2784805,-96.2296745,10540,44.4888982,-122.5372084,private,0,0,0,0,0,0,0,0,0,12,0,0,12,12,3.000623353
38060,33.1857653,-112.0678624,19460,34.4893614,-87.0971469,private,0,0,0,0,0,0,0,0,0,12,0,0,12,12,3.000623353
38060,33.1857653,-112.0678624,23660,40.9309446,-90.2137921,private,0,0,11,0,0,11,11,0,0,34,0,0,34,34,3.014337121
38060,33.1857653,-112.0678624,46540,43.3322796,-75.1731893,private,0,0,0,0,0,0,0,0,0,12,0,0,12,12,3.000623353
38060,33.1857653,-112.0678624,45220,30.3864255,-84.2804096,private,0,0,0,0,0,0,0,0,0,12,0,0,12,12,3.000623353
38060,33.1857653,-112.0678624,25620,31.2737661,-89.3006335,private,0,0,0,0,0,0,0,0,0,12,0,0,12,12,3.000623353
49740,32.7739424,-113.910905,17980,32.4193768,-84.8437095,private,0,0,0,0,0,0,0,0,0,12,0,0,12,12,3.000623353
49740,32.7739424,-113.910905,42200,34.5370572,-120.0399729,private,0,0,0,0,0,0,0,0,0,12,0,0,12,12,3.000623353
31080,34.1087033,-118.1827533,21780,38.0200703,-87.5861659,private,0,0,0,0,0,0,0,0,0,12,0,0,12,12,3.000623353
31080,34.1087033,-118.1827533,13940,43.2163568,-112.3992058,private,0,0,11,0,0,11,11,0,0,12,0,0,12,12,3.000623353
41860,37.7737185,-122.2744317,26620,34.7832617,-86.7348706,private,0,0,0,0,0,0,0,0,0,12,0,0,12,12,3.000623353
41860,37.7737185,-122.2744317,35980,41.4726517,-72.1086339,private,0,0,0,0,0,0,0,0,0,12,0,0,12,12,3.000623353
42660,47.4905993,-121.833996,18580,27.8335972,-97.5089575,private,0,0,0,0,0,0,0,0,0,12,0,0,12,12,3.000623353
42660,47.4905993,-121.833996,12740,44.2749884,-72.6095138,private,0,0,0,0,0,0,0,0,0,12,0,0,12,12,3.000623353
42660,47.4905993,-121.833996,48180,31.1331137,-82.3686504,private,0,0,0,0,0,0,0,0,0,12,0,0,12,12,3.000623353
42660,47.4905993,-121.833996,37900,40.7088872,-89.6974658,private,0,0,0,0,0,0,0,0,0,12,0,0,12,12,3.000623353
34580,48.4932917,-121.8157703,10900,40.7893392,-75.398158,private,0,0,0,0,0,0,0,0,0,12,0,0,12,12,3.000623353
34580,48.4932917,-121.8157703,35900,36.2088833,-81.1660949,private,0,0,0,0,0,0,0,0,0,12,0,0,12,12,3.000623353
34580,48.4932917,-121.8157703,48180,31.1331137,-82.3686504,private,0,0,0,0,0,0,0,0,0,12,0,0,12,12,3.000623353
34580,48.4932917,-121.8157703,42460,34.764114,-85.9800556,private,0,0,0,0,0,0,0,0,0,12,0,0,12,12,3.000623353
34580,48.4932917,-121.8157703,19780,41.5770501,-93.7597124,private,0,0,0,0,0,0,0,0,0,12,0,0,12,12,3.000623353
34580,48.4932917,-121.8157703,36260,41.276061,-113.126226,private,0,0,0,0,0,0,0,0,0,12,0,0,12,12,3.000623353
34580,48.4932917,-121.8157703,16180,39.1530598,-119.7473681,private,0,0,0,0,0,0,0,0,0,12,0,0,12,12,3.000623353
43220,47.3541257,-123.1738498,35620,40.77493,-73.873758,private,0,0,0,0,0,0,0,0,0,12,0,0,12,12,3.000623353
43220,47.3541257,-123.1738498,25420,40.335915,-77.0504897,private,0,0,0,0,0,0,0,0,0,12,0,0,12,12,3.000623353
43220,47.3541257,-123.1738498,16860,35.0493612,-85.3611582,private,0,0,0,0,0,0,0,12,0,0,0,0,12,12,3.000623353
43220,47.3541257,-123.1738498,40300,42.041884,-89.3201764,private,0,0,0,0,0,0,0,0,0,12,0,0,12,12,3.000623353
43220,47.3541257,-123.1738498,18580,27.8335972,-97.5089575,private,0,0,11,0,0,11,11,0,0,12,0,0,12,12,3.000623353
37980,39.8949576,-75.3119824,29060,43.5191091,-71.4253661,private,0,11,0,0,11,0,11,0,11,0,0,11,0,11,3
37980,39.8949576,-75.3119824,21580,36.5096687,-106.6939829,private,0,0,11,0,0,11,11,0,0,11,0,0,11,11,3
12060,33.693728,-84.3999113,24540,40.555961,-104.383666,private,0,0,11,0,0,11,11,0,0,22,0,0,22,22,3.006856884
12060,33.693728,-84.3999113,14020,39.2417362,-86.6717544,private,0,0,11,0,0,11,11,0,0,11,0,0,11,11,3
33100,26.1018281,-80.4787552,42020,35.3852242,-120.4475445,private,0,0,11,0,0,11,11,0,0,11,0,0,11,11,3
19100,32.8491708,-96.9704894,18500,42.2667252,-77.3855253,private,0,0,11,0,0,11,11,0,0,11,0,0,11,11,3
19100,32.8491708,-96.9704894,42020,35.3852242,-120.4475445,private,0,0,11,0,0,11,11,0,0,11,0,0,11,11,3
26420,29.7495926,-95.3536422,48140,45.0539796,-89.7579047,private,0,0,22,0,0,22,22,0,0,11,0,0,11,11,3
26420,29.7495926,-95.3536422,37900,40.7088872,-89.6974658,private,0,0,11,0,0,11,11,0,0,11,0,0,11,11,3
20900,29.2784805,-96.2296745,12540,35.3466288,-118.7295064,private,0,0,11,0,0,11,11,0,0,11,0,0,11,11,3
38060,33.1857653,-112.0678624,36460,42.2390986,-78.662332,private,0,0,11,0,0,11,11,0,11,11,0,11,11,22,3.006856884
49740,32.7739424,-113.910905,45820,39.0413888,-95.8026393,private,0,0,11,0,0,11,11,0,0,11,0,0,11,11,3
31080,34.1087033,-118.1827533,44300,40.9091275,-77.8478769,private,0,0,11,0,0,11,11,0,0,11,0,0,11,11,3
42660,47.4905993,-121.833996,31420,32.8562163,-83.714305,private,0,0,11,0,0,11,11,0,0,11,0,0,11,11,3
42660,47.4905993,-121.833996,12220,32.6040644,-85.3530477,private,11,0,0,0,0,11,11,0,0,11,0,0,11,11,3
14460,42.517606,-71.0219925,36460,42.2390986,-78.662332,private,0,0,0,0,0,0,0,0,0,11,0,0,11,11,3
14460,42.517606,-71.0219925,20700,41.0562401,-75.3290651,private,0,0,0,0,0,0,0,0,0,11,0,0,11,11,3
14460,42.517606,-71.0219925,15680,38.2202894,-76.5303837,private,0,0,0,0,0,0,0,0,0,11,0,0,11,11,3
14460,42.517606,-71.0219925,31420,32.8562163,-83.714305,private,0,0,0,0,0,0,0,0,0,11,0,0,11,11,3
14460,42.517606,-71.0219925,22900,35.4631192,-94.2997413,private,0,0,0,0,0,0,0,0,0,11,0,0,11,11,3
35620,40.77493,-73.873758,13620,44.6525477,-71.2894309,private,0,0,0,0,0,0,0,0,0,11,0,0,11,11,3
35620,40.77493,-73.873758,19460,34.4893614,-87.0971469,private,0,0,0,0,0,0,0,0,0,11,0,0,11,11,3
35620,40.77493,-73.873758,12220,32.6040644,-85.3530477,private,0,0,0,0,0,0,0,0,0,22,0,0,22,22,3.006856884
35620,40.77493,-73.873758,23380,41.3553193,-83.1427763,private,0,0,0,0,0,0,0,0,0,11,0,0,11,11,3
35620,40.77493,-73.873758,24540,40.555961,-104.383666,private,0,0,0,0,0,0,0,0,0,11,0,0,11,11,3
35620,40.77493,-73.873758,39820,40.7605142,-122.0435556,private,0,0,0,0,0,0,0,0,0,11,0,0,11,11,3
37980,39.8949576,-75.3119824,31660,44.5943758,-74.31067,private,0,0,0,0,0,0,0,0,11,0,0,11,0,11,3
37980,39.8949576,-75.3119824,24340,43.0375977,-85.7781669,private,0,0,0,0,0,0,0,0,0,11,0,0,11,11,3
37980,39.8949576,-75.3119824,29180,29.9577733,-92.0493498,private,0,0,0,0,0,0,0,0,0,11,0,0,11,11,3
37980,39.8949576,-75.3119824,32580,26.3963839,-98.18099,private,0,0,0,0,0,0,0,0,0,11,0,0,11,11,3
47900,38.7982054,-77.4868816,28300,42.9254596,-72.2481828,private,0,0,0,0,0,0,0,0,0,11,0,0,11,11,3
47900,38.7982054,-77.4868816,31660,44.5943758,-74.31067,private,0,0,0,0,0,0,0,0,0,11,0,0,11,11,3
47900,38.7982054,-77.4868816,20700,41.0562401,-75.3290651,private,0,0,0,0,0,0,0,0,0,11,0,0,11,11,3
47900,38.7982054,-77.4868816,42540,41.3228806,-75.8981877,private,0,0,0,0,0,0,0,0,0,11,0,0,11,11,3
47900,38.7982054,-77.4868816,31420,32.8562163,-83.714305,private,0,0,0,0,0,0,0,0,0,11,0,0,11,11,3
47900,38.7982054,-77.4868816,19460,34.4893614,-87.0971469,private,0,0,0,0,0,0,0,0,0,11,0,0,11,11,3
47900,38.7982054,-77.4868816,15620,44.3287385,-85.3264287,private,0,0,0,0,0,0,0,0,11,0,0,11,0,11,3
47900,38.7982054,-77.4868816,39900,40.5007953,-119.7311608,private,0,0,0,0,0,0,0,0,0,11,0,0,11,11,3
12060,33.693728,-84.3999113,45380,39.5455242,-89.2795927,private,0,0,0,0,0,0,0,0,0,22,0,0,22,22,3.006856884
12060,33.693728,-84.3999113,36260,41.276061,-113.126226,private,0,0,0,0,0,0,0,0,0,11,0,0,11,11,3
12060,33.693728,-84.3999113,15780,33.5675198,-92.7082209,private,0,0,0,0,0,0,0,0,0,11,0,0,11,11,3
12060,33.693728,-84.3999113,29420,35.717705,-113.7496891,private,0,0,0,0,0,0,0,0,0,11,0,0,11,11,3
33100,26.1018281,-80.4787552,30100,43.7857256,-72.1591415,private,0,0,0,0,0,0,0,0,11,0,0,11,0,11,3
33100,26.1018281,-80.4787552,44300,40.9091275,-77.8478769,private,0,0,0,0,0,0,0,0,0,11,0,0,11,11,3
33460,45.096664,-93.275361,49180,36.0788515,-80.3450642,private,0,0,0,0,0,0,0,0,0,11,0,0,11,11,3
33460,45.096664,-93.275361,14860,41.2274128,-73.3670614,private,0,0,0,0,0,0,0,0,0,11,0,0,11,11,3
33460,45.096664,-93.275361,43900,34.9332708,-81.9910522,private,0,0,0,0,0,0,0,0,0,11,0,0,11,11,3
33460,45.096664,-93.275361,37120,31.4306536,-85.609476,private,0,0,0,0,0,0,0,0,0,11,0,0,11,11,3
33460,45.096664,-93.275361,14020,39.2417362,-86.6717544,private,0,0,0,0,0,0,0,0,0,11,0,0,11,11,3
33460,45.096664,-93.275361,17860,38.9864864,-92.5851888,private,0,0,0,0,0,0,0,0,0,11,0,0,11,11,3
16980,41.8235214,-87.8282967,25980,31.7787881,-81.5764801,private,0,0,0,0,0,0,0,0,0,11,0,0,11,11,3
16980,41.8235214,-87.8282967,22420,43.0210768,-83.7063718,private,0,0,0,0,0,0,0,0,0,11,0,0,11,11,3
16980,41.8235214,-87.8282967,16140,42.039492,-94.8676471,private,0,0,0,0,0,0,0,0,0,11,0,0,11,11,3
16980,41.8235214,-87.8282967,10500,31.6444531,-84.1119078,private,0,0,0,0,0,0,0,0,0,11,0,0,11,11,3
16980,41.8235214,-87.8282967,37120,31.4306536,-85.609476,private,0,0,0,0,0,0,0,0,0,11,0,0,11,11,3
16980,41.8235214,-87.8282967,46180,34.3400327,-88.6511835,private,0,0,0,0,0,0,0,0,0,11,0,0,11,11,3
16980,41.8235214,-87.8282967,44220,39.9170315,-83.783676,private,0,0,0,0,0,0,0,0,0,11,0,0,11,11,3
16980,41.8235214,-87.8282967,13900,46.887031,-100.979592,private,0,0,0,0,0,0,0,0,0,11,0,0,11,11,3
16980,41.8235214,-87.8282967,33740,32.734255,-92.0995498,private,0,0,0,0,0,0,0,0,0,11,0,0,11,11,3
16980,41.8235214,-87.8282967,27220,44.048662,-110.426087,private,0,0,0,0,0,0,0,0,0,11,0,0,11,11,3
19100,32.8491708,-96.9704894,49020,39.2729744,-78.4718276,private,0,0,0,0,0,0,0,0,0,11,0,0,11,11,3
19100,32.8491708,-96.9704894,18260,36.2772512,-85.4685013,private,0,0,0,0,0,0,0,0,0,11,0,0,11,11,3
19100,32.8491708,-96.9704894,14020,39.2417362,-86.6717544,private,0,0,0,0,0,0,0,0,0,11,0,0,11,11,3
26420,29.7495926,-95.3536422,25180,39.5544327,-77.9845935,private,0,0,0,0,0,0,0,0,0,11,0,0,11,11,3
26420,29.7495926,-95.3536422,44260,33.5146172,-89.0775079,private,0,0,0,0,0,0,0,0,0,11,0,0,11,11,3
26420,29.7495926,-95.3536422,14540,37.0468241,-86.3970408,private,0,0,0,0,0,0,0,0,0,11,0,0,11,11,3
26420,29.7495926,-95.3536422,22020,46.9148591,-96.9601826,private,0,0,0,0,0,0,0,0,0,11,0,0,11,11,3
26420,29.7495926,-95.3536422,32540,34.9255401,-95.7481302,private,0,0,0,0,0,0,0,0,0,11,0,0,11,11,3
20900,29.2784805,-96.2296745,10900,40.7893392,-75.398158,private,0,0,0,0,0,0,0,0,0,11,0,0,11,11,3
20900,29.2784805,-96.2296745,35100,35.1168292,-77.0813197,private,0,0,0,0,0,0,0,0,0,11,0,0,11,11,3
20900,29.2784805,-96.2296745,28020,42.2462657,-85.5328544,private,0,0,0,0,0,0,0,0,0,11,0,0,11,11,3
20900,29.2784805,-96.2296745,19700,32.1845231,-107.7471911,private,0,0,0,0,0,0,0,0,0,11,0,0,11,11,3
26420,29.7495926,-95.3536422,10300,41.8960225,-84.0743563,private,0,0,0,0,0,0,0,0,0,11,0,0,11,11,3
38060,33.1857653,-112.0678624,47020,28.7314546,-97.1969934,private,0,0,0,0,0,0,0,0,0,11,0,0,11,11,3
38060,33.1857653,-112.0678624,40620,37.8663263,-91.7903492,private,0,0,0,0,0,0,0,0,0,11,0,0,11,11,3
38060,33.1857653,-112.0678624,39740,40.4139565,-75.9268598,private,0,0,0,0,0,0,0,0,0,11,0,0,11,11,3
38060,33.1857653,-112.0678624,29980,35.2204764,-87.396546,private,0,0,0,0,0,0,0,0,0,11,0,0,11,11,3
38060,33.1857653,-112.0678624,41460,38.9645697,-97.6633868,private,0,0,0,0,0,0,0,0,0,11,0,0,11,11,3
49740,32.7739424,-113.910905,49340,42.2173112,-71.9255354,private,0,0,0,0,0,0,0,0,0,11,0,0,11,11,3
49740,32.7739424,-113.910905,18500,42.2667252,-77.3855253,private,0,0,0,0,0,0,0,0,0,11,0,0,11,11,3
49740,32.7739424,-113.910905,49620,39.9217514,-76.7288887,private,0,0,0,0,0,0,0,0,0,11,0,0,11,11,3
49740,32.7739424,-113.910905,48180,31.1331137,-82.3686504,private,0,0,0,0,0,0,0,0,0,11,0,0,11,11,3
49740,32.7739424,-113.910905,26620,34.7832617,-86.7348706,private,0,0,0,0,0,0,0,0,0,11,0,0,11,11,3
49740,32.7739424,-113.910905,43780,41.7749808,-86.1230143,private,0,0,0,0,0,0,0,0,0,11,0,0,11,11,3
49740,32.7739424,-113.910905,45460,39.4784006,-87.3111315,private,0,0,0,0,0,0,0,0,0,11,0,0,11,11,3
49740,32.7739424,-113.910905,22420,43.0210768,-83.7063718,private,0,0,0,0,0,0,0,0,0,11,0,0,11,11,3
49740,32.7739424,-113.910905,39500,40.0271652,-91.3898384,private,0,0,0,0,0,0,0,0,0,11,0,0,11,11,3
49740,32.7739424,-113.910905,41460,38.9645697,-97.6633868,private,0,0,0,0,0,0,0,0,0,11,0,0,11,11,3
49740,32.7739424,-113.910905,47380,31.4272264,-97.0934727,private,0,0,0,0,0,0,0,0,0,11,0,0,11,11,3
31080,34.1087033,-118.1827533,13540,43.0353254,-73.1114603,private,0,0,0,0,0,0,0,0,0,11,0,0,11,11,3
31080,34.1087033,-118.1827533,20700,41.0562401,-75.3290651,private,0,0,0,0,0,0,0,0,0,11,0,0,11,11,3
31080,34.1087033,-118.1827533,33860,32.3656313,-86.4045848,private,0,0,0,0,0,0,0,0,0,11,0,0,11,11,3
31080,34.1087033,-118.1827533,27740,36.2658223,-82.3326926,private,0,0,0,0,0,0,0,0,0,11,0,0,11,11,3
31080,34.1087033,-118.1827533,47020,28.7314546,-97.1969934,private,0,0,0,0,0,0,0,0,0,11,0,0,11,11,3
31080,34.1087033,-118.1827533,33940,38.3425479,-108.1622366,private,0,0,0,0,0,0,0,0,0,11,0,0,11,11,3
31080,34.1087033,-118.1827533,40420,42.331183,-89.0429139,private,0,0,0,0,0,0,0,0,0,11,0,0,11,11,3
41860,37.7737185,-122.2744317,12020,33.943984,-83.2138965,private,0,0,0,0,0,0,0,0,0,11,0,0,11,11,3
41860,37.7737185,-122.2744317,45860,41.7918833,-73.2354042,private,0,0,0,0,0,0,0,0,0,11,0,0,11,11,3
41860,37.7737185,-122.2744317,44300,40.9091275,-77.8478769,private,0,0,0,0,0,0,0,0,0,11,0,0,11,11,3
41860,37.7737185,-122.2744317,41540,38.3995211,-75.4782615,private,0,0,0,0,0,0,0,0,0,11,0,0,11,11,3
42660,47.4905993,-121.833996,45220,30.3864255,-84.2804096,private,0,0,0,0,0,0,0,0,0,11,0,0,11,11,3
34580,48.4932917,-121.8157703,32820,35.0244194,-89.8719712,private,0,0,0,0,0,0,0,0,0,11,0,0,11,11,3
34580,48.4932917,-121.8157703,10300,41.8960225,-84.0743563,private,0,0,0,0,0,0,0,0,0,11,0,0,11,11,3
43220,47.3541257,-123.1738498,15540,44.6891168,-73.0411707,private,0,0,0,0,0,0,0,0,0,11,0,0,11,11,3
43220,47.3541257,-123.1738498,11700,35.5956693,-82.6816145,private,0,0,0,0,0,0,0,0,0,11,0,0,11,11,3
43220,47.3541257,-123.1738498,27740,36.2658223,-82.3326926,private,0,0,0,0,0,0,0,0,0,11,0,0,11,11,3
